una lesbiana	Phrase
una ampolla llena	Phrase
un ángel	Phrase
un angelito	Phrase
el cochecito	Phrase
un pequeño camión	Phrase
la abuela	Phrase
paquete	Derivative
la mochila	Phrase
la diana	Phrase
la caja	Phrase
la caja	Phrase
una glorieta cayó hollín	Phrase
gilipollas	Compound
bloc	Unmotivated
tontuela	Derivative
cuclillas	Derivative
un bollo	Phrase
tormenta	Unmotivated
mi primo	Phrase
hermanito	Derivative
una monada	Phrase
piedra	Unmotivated
un folleto	Phrase
la puerta	Phrase
el tambor	Phrase
el sombrero hongo	Phrase
fusta	Unmotivated
becerro	Derivative
un departamentito	Phrase
criatura estuviese cuestionar su forma	Phrase
resto queda deberá	Phrase
vientre	Unmotivated
cartel	Unmotivated
un sendero	Phrase
pamela	Unmotivated
te imaginas	Phrase
frescor	Derivative
niño	Derivative
tipo	Derivative
excitable el compañerito	Phrase
tipo	Derivative
había un grupo retorcidos	Phrase
un sándwich	Phrase
mata	Unmotivated
guardaespaldas	Compound
buzón	Derivative
la pobrecilla	Phrase
pobre muchacho	Phrase
un momento	Phrase
un instante	Phrase
un error	Phrase
un cigarrito aprisa	Phrase
gitanas	Unmotivated
caramelo	Derivative
tachuela	Derivative
un punto	Phrase
pequeña parcelita	Phrase
un regalito	Phrase
una tablita la	Phrase
un rectángulo	Phrase
un pastelillo	Phrase
pequeña guarida	Phrase
un encanto	Phrase
poza	Unmotivated
alma	Unmotivated
la puerta	Phrase
patio	Unmotivated
dinamismo	Derivative
damisela	Unmotivated
pieza	Unmotivated
un niño	Phrase
teatro	Unmotivated
teatro	Unmotivated
la niña	Phrase
puta	Unmotivated
esclava	Unmotivated
la niña	Phrase
puto viejo	Phrase
abuelo	Unmotivated
bisabuelo	Derivative
obra	Unmotivated
previstos para el lunes volvió sumirme	Phrase
casita	Derivative
la jarra	Phrase
figura	Unmotivated
frase había acudido	Phrase
padre	Unmotivated
broma	Unmotivated
y zarrapastrón	Phrase
una gomita	Phrase
trapo	Derivative
vocecita	Derivative
el bobo	Phrase
aluminio	Derivative
móvil	Unmotivated
retoño	Derivative
parterre	Compound
un sitio escondido para	Phrase
hora	Unmotivated
reloj	Unmotivated
comodidad	Derivative
palomilla	Derivative
una paloma	Phrase
niña	Unmotivated
calor	Unmotivated
ama de casa	Phrase
joe	Unmotivated
leñera añadida	Phrase
violín	Unmotivated
cresta	Unmotivated
jardín	Derivative
una tórtola	Phrase
una taza	Phrase
taza	Unmotivated
una taza	Phrase
un montón	Phrase
untuoso una bola	Phrase
un puñado	Phrase
los guisantes	Phrase
una burrita	Phrase
estrella	Unmotivated
problema	Derivative
cementerio	Derivative
un clavo	Phrase
clavo	Derivative
potrillo	Derivative
cuál es tu punto vulnerable	Phrase
varita	Unmotivated
idilio	Unmotivated
tomate	Unmotivated
lengua de	Phrase
unidad	Derivative
si fuera alfiletero	Phrase
hoja acicular	Phrase
un cordero	Phrase
una pequeña gruta	Phrase
pequeño lago	Phrase
el pachón	Phrase
una chispa	Phrase
dieta	Unmotivated
pasillo	Derivative
una pequeña tienda	Phrase
reunión	Derivative
déficit	Unmotivated
escalón	Derivative
el bolso	Phrase
la chaqueta	Phrase
las bragas	Phrase
copa	Unmotivated
amigo	Unmotivated
una estufa	Phrase
un canario	Phrase
gota	Unmotivated
un humilladero	Phrase
un pañuelo	Phrase
caperucita roja	Phrase
una tarjeta	Phrase
el cepillo	Phrase
una pequeña cazuela	Phrase
parece un bosquecillo cualquier otro	Phrase
un palo	Phrase
una espiga delgada	Phrase
picapleitos	Derivative
sombrero	Derivative
un ovillo	Phrase
un niño	Phrase
niño indigestión anticipada	Phrase
el martillo	Phrase
la llave	Phrase
una pequeña librería	Phrase
libro	Unmotivated
libro	Unmotivated
un botón	Phrase
bigote	Derivative
alfombra india	Phrase
saltamontes	Unmotivated
el gatillo	Phrase
rueda	Unmotivated
una galleta	Phrase
su salita	Phrase
mordisqueando la punta	Phrase
pocillo	Derivative
elevación	Derivative
enseñé la patita	Phrase
una veleta	Phrase
una corona	Phrase
una cuenta una moneda	Phrase
un cubo	Phrase
una capilla	Phrase
vestido primavera y	Phrase
el caldero	Phrase
un pedacito	Phrase
rincón	Derivative
el pescante	Phrase
la cabrita	Phrase
nena	Unmotivated
gata	Unmotivated
el cochecito	Phrase
robustez de	Phrase
un cesto	Phrase
canasta	Unmotivated
una escoba	Phrase
una caja	Phrase
un paisaje	Phrase
sastre	Unmotivated
el cuello	Phrase
el borde	Phrase
paso	Unmotivated
un círculo	Phrase
un cubito	Phrase
un conejo	Phrase
tienda	Unmotivated
belleza	Derivative
vaquilla	Derivative
maletín	Derivative
soldado de ametralladoras ocupaba	Phrase
un cuchitril	Phrase
un pollito	Phrase
una putilla fina	Phrase
fresca una flor	Phrase
florecilla	Derivative
café	Unmotivated
el índice	Phrase
el silicio	Phrase
viena que	Phrase
ala	Unmotivated
cruz	Unmotivated
manía	Derivative
unos andares muy vistosos pelo	Phrase
cochinillo piel	Phrase
frasco	Unmotivated
perita agua	Phrase
el lóbulo	Phrase
una lámpara	Phrase
un cable	Phrase
la comadreja	Phrase
un banco	Phrase
tabla voló aires	Phrase
el cráneo	Phrase
refrigerador	Derivative
una diversión	Phrase
el cuello	Phrase
cartón	Derivative
un quiosco	Phrase
ruinosa avioneta	Phrase
línea	Unmotivated
una nota	Phrase
un cubo	Phrase
la barca	Phrase
cesta	Unmotivated
pequeña linterna puesta	Phrase
una trampa	Phrase
carita	Derivative
carita ansiosa	Phrase
cuchara usé	Phrase
venía desde zinkensdamm	Phrase
el meñique	Phrase
mariscal campo	Phrase
piernotas más duras	Phrase
madre	Unmotivated
tu madre	Phrase
el osito	Phrase
espada corta	Phrase
tesoro	Derivative
un bebé	Phrase
el joven	Phrase
rapaz con	Phrase
regurgitando leche	Phrase
el molino	Phrase
monjecillo	Derivative
ayuda	Derivative
motos	Unmotivated
sesos	Unmotivated
una nube	Phrase
el cadáver	Phrase
hermano menor fue	Phrase
hombrecillo	Derivative
el hombrecillo	Phrase
palacete	Derivative
el ratón	Phrase
mi mamita	Phrase
un cuartucho	Phrase
un sitio	Phrase
propiedades ya verás	Phrase
la pelota	Phrase
lavabo pequeñísimo y descascarillado	Phrase
el pueblo	Phrase
la placita	Phrase
luna	Unmotivated
médula	Derivative
muerte	Unmotivated
la reja	Phrase
una prostituta	Phrase
un hilo	Phrase
el pernil	Phrase
nariz	Unmotivated
nariz respingada	Phrase
libreta	Derivative
novedad	Derivative
etiqueta	Derivative
recipiente químico por última	Phrase
una camilla	Phrase
una bocanada	Phrase
lámina	Derivative
imagen	Unmotivated
el rabo	Phrase
hoguera	Derivative
el soldadito	Phrase
la ventanilla	Phrase
comisaría	Derivative
el altarcillo	Phrase
el mono	Phrase
soga	Unmotivated
burro	Unmotivated
octavo egb	Phrase
abordó una persona	Phrase
islote	Derivative
oveja	Unmotivated
nuez moscada	Phrase
perro	Unmotivated
fajo	Derivative
una muñeca	Phrase
el muñeco	Phrase
dueña	Derivative
un papelito	Phrase
un parque	Phrase
grupito	Derivative
manera	Derivative
piedra	Unmotivated
una madriguera	Phrase
perro	Unmotivated
el michino	Phrase
fortalezas hechas	Phrase
un botones que	Phrase
píldora	Derivative
un tomate	Phrase
abandonaron descampado	Phrase
– menudo saque hija –	Phrase
una moneda	Phrase
una plataforma	Phrase
el mapa	Phrase
filete de	Phrase
surgía una llamita	Phrase
la llama	Phrase
capa	Unmotivated
calor	Unmotivated
copa	Unmotivated
habitación	Derivative
una habitación	Phrase
casilla	Derivative
tizón lo clavan	Phrase
un estante	Phrase
la mitad	Phrase
un cojín	Phrase
cenicero los que hay en las tabernas	Phrase
ceniza	Derivative
pimpollo	Derivative
viajero extraviado	Phrase
polvo	Unmotivated
un hilo de	Phrase
banderín	Derivative
el alférez	Phrase
un cerdito	Phrase
una lluvia	Phrase
barbera	Derivative
vigilaré mi principito	Phrase
water	Unmotivated
la tabla	Phrase
trinchando pechuga	Phrase
anillo	Derivative
el dedo	Phrase
hilillo de	Phrase
una varilla	Phrase
vigilia fabricaba minúsculas piezas	Phrase
un ropero	Phrase
carta	Unmotivated
el opúsculo	Phrase
un pajarito	Phrase
un perrito aguas	Phrase
un atril	Phrase
punto	Unmotivated
merengue	Unmotivated
la bolsita	Phrase
el sarampión	Phrase
una pareja	Phrase
una salchichita	Phrase
un pequeño navío	Phrase
una pluma	Phrase
el silbato	Phrase
letra	Unmotivated
servir puerros	Phrase
canción	Unmotivated
raya y	Phrase
amigo	Unmotivated
mitad	Unmotivated
media hora	Phrase
una percha	Phrase
bulto	Unmotivated
familia	Unmotivated
la gente	Phrase
un romance	Phrase
una mordaza	Phrase
espacio	Unmotivated
mano	Unmotivated
la aguja	Phrase
pez	Unmotivated
una lechuga	Phrase
estanque	Unmotivated
caña no fallaba	Phrase
el recuadro	Phrase
plantita estiraba	Phrase
el macho	Phrase
la hembra	Phrase
una ambulancia	Phrase
tal	Unmotivated
un punzón picar	Phrase
chuleta preparada	Phrase
vástago	Derivative
la semilla	Phrase
la enfermera	Phrase
bodegón cebollas	Phrase
un vaso	Phrase
cristal de estrella	Phrase
cristal	Unmotivated
resquicio	Derivative
un grupo	Phrase
mancha	Unmotivated
el elfo	Phrase
de música	Phrase
señorita	Derivative
nota dominical	Phrase
pequeño diccionario	Phrase
palabra	Unmotivated
palabra	Unmotivated
el sol	Phrase
menudo bromista está hecho	Phrase
un haz	Phrase
una estatuilla	Phrase
grajo	Derivative
animador	Derivative
pequeña luna	Phrase
bendito sea viejo hobbit	Phrase
el viejecillo	Phrase
la viejecita	Phrase
pásame un muslito de pollo	Phrase
tarima	Unmotivated
web métodos	Phrase
máquina	Unmotivated
un árbol	Phrase
árbol navidad	Phrase
una pequeña costra	Phrase
el tío	Phrase
una fuente	Phrase
modesto estudiante	Phrase
cinta	Unmotivated
movedizo	Derivative
cita	Unmotivated
pequeña figura	Phrase
serenata	Unmotivated
un puesto	Phrase
transparente coloqué	Phrase
consígueme hojas	Phrase
un refugio	Phrase
tejadillo	Derivative
el dedo medio	Phrase
la aguja	Phrase
fragmento	Unmotivated
el zapato	Phrase
la mesa	Phrase
mesita	Derivative
veía un escabel sobre	Phrase
tipo era endeble	Phrase
encontrar capilla sintoísta	Phrase
jersey	Unmotivated
toda basura hay	Phrase
vela	Unmotivated
una vela	Phrase
una lucecita	Phrase
cambio	Unmotivated
hijo	Derivative
tamiz	Unmotivated
una lechuza	Phrase
una pastilla	Phrase
el cuadro	Phrase
un plato	Phrase
danza	Unmotivated
papá	Unmotivated
mi padre	Phrase
un taxi	Phrase
becerro	Derivative
tía	Unmotivated
la tía	Phrase
el titular	Phrase
un hermoso juguete	Phrase
la camiseta	Phrase
pequeño es ayuda	Phrase
un triangulito adhesivo enganchado	Phrase
una caja	Phrase
cagueta dijo que dispensase	Phrase
carita	Derivative
una criatura	Phrase
un palillo	Phrase
una bandeja	Phrase
un riachuelo	Phrase
cuerpo	Unmotivated
guinda	Unmotivated
estábamos nerviosísimas pato pobre ángel	Phrase
la servilleta	Phrase
carbono	Derivative
callejón	Derivative
el paquete	Phrase
un manojo	Phrase
cilindro	Unmotivated
guerras	Unmotivated
vainilla	Derivative
viudita nueva	Phrase
el curita	Phrase
pobre verso huérfano	Phrase
pueblo	Unmotivated
fiesta	Unmotivated
un tenedor	Phrase
tarjeta	Derivative
un pelo	Phrase
una peonza	Phrase
inmutó ni una ola	Phrase
una sola hebra	Phrase
una chincheta	Phrase
tren	Unmotivated
vodka	Derivative
hidrógeno	Derivative
puerta	Unmotivated
la cima	Phrase
la cima	Phrase
un sonsonete	Phrase
arruga	Derivative
humorista	Derivative
sino una salchichita	Phrase
una muestra	Phrase
barandilla	Derivative
una libélula	Phrase
la cuerda	Phrase
un paquete	Phrase
vagoneta embistió	Phrase
la tapa	Phrase
cosa	Unmotivated
la corona	Phrase
una rama	Phrase
una liebre bastara	Phrase
una tapadera	Phrase
cariño	Derivative
ladrón	Derivative
signo	Unmotivated
marca	Unmotivated
pico	Unmotivated
un espejo	Phrase
un grano de	Phrase
grano	Unmotivated
el germen de	Phrase
vallizuelo	Derivative
una risita	Phrase
martes	Unmotivated
una mueca	Phrase
negras supersticiones	Phrase
una diadema	Phrase
cofia	Unmotivated
gorra	Unmotivated
el negrito	Phrase
artículo	Unmotivated
líneas describiendo	Phrase
un hombrecillo	Phrase
semilla viviente mandíbula en mandíbula	Phrase
boceto	Unmotivated
un taco de	Phrase
perra	Derivative
nariz	Unmotivated
una pieza	Phrase
importe	Derivative
partícula	Derivative
orden	Unmotivated
pinche	Unmotivated
rímel por delante	Phrase
rábanos	Derivative
la correa	Phrase
la cadena	Phrase
torpe	Unmotivated
trozo	Derivative
la punta	Phrase
resorte	Derivative
un mazo	Phrase
etiqueta	Derivative
cachorro	Derivative
una taza	Phrase
pañuelo	Derivative
un cuaderno	Phrase
costurera	Derivative
la cuerda	Phrase
judiíto pequeño	Phrase
la escalera	Phrase
clasificación	Derivative
las esposas	Phrase
mujer chiquita	Phrase
broma	Unmotivated
intentaba realizar pequeña broma	Phrase
canalón sangre	Phrase
volvía un párvulo	Phrase
el corpiño	Phrase
