lesbiana	Phrase
ampolla llena	Phrase
ángel	Phrase
angelito	Derivative
cochecito	Derivative
pequeño camión	Phrase
abuela	Unmotivated
paquete	Derivative
mochila	Derivative
diana	Derivative
caja	Phrase
caja	Phrase
glorieta cayó hollín	Phrase
gilipollas	Compound
bloc	Unmotivated
tontuela	Derivative
cuclillas	Derivative
bollo	Unmotivated
tormenta	Derivative
mi primo	Phrase
hermanito	Derivative
monada	Derivative
piedra	Unmotivated
folleto	Derivative
puerta	Unmotivated
tambor	Phrase
sombrero hongo	Phrase
fusta	Unmotivated
becerro	Derivative
departamentito	Derivative
criatura estuviese cuestionar su forma	Phrase
resto queda deberá	Phrase
vientre	Unmotivated
cartel	Unmotivated
sendero	Derivative
pamela	Unmotivated
te imaginas	Phrase
frescor	Derivative
niño	Derivative
tipo	Derivative
excitable el compañerito	Phrase
tipo	Derivative
había un grupo retorcidos	Phrase
sándwich	Phrase
mata	Unmotivated
guardaespaldas	Derivative
buzón	Derivative
pobrecilla	Derivative
pobre muchacho	Phrase
momento	Derivative
instante	Derivative
error	Phrase
cigarrito aprisa	Phrase
gitanas	Unmotivated
caramelo	Derivative
tachuela	Derivative
punto	Unmotivated
pequeña parcelita	Phrase
regalito	Derivative
tablita la	Phrase
rectángulo	Phrase
pastelillo	Derivative
pequeña guarida	Phrase
encanto	Derivative
poza	Derivative
alma	Unmotivated
puerta	Unmotivated
patio	Unmotivated
dinamismo	Derivative
damisela	Unmotivated
pieza	Unmotivated
niño	Phrase
teatro	Unmotivated
teatro	Unmotivated
niña	Phrase
puta	Unmotivated
esclava	Unmotivated
niña	Phrase
puto viejo	Phrase
abuelo	Unmotivated
bisabuelo	Derivative
obra	Unmotivated
previstos para el lunes volvió sumirme	Phrase
casita	Unmotivated
jarra	Phrase
figura	Unmotivated
frase había acudido	Phrase
padre	Unmotivated
broma	Unmotivated
y zarrapastrón	Phrase
gomita	Unmotivated
trapo	Derivative
vocecita	Derivative
bobo	Phrase
aluminio	Derivative
móvil	Unmotivated
retoño	Derivative
parterre	Compound
sitio escondido para	Phrase
hora	Unmotivated
reloj	Unmotivated
comodidad	Derivative
palomilla	Derivative
paloma	Phrase
niña	Unmotivated
calor	Unmotivated
ama de casa	Phrase
joe	Unmotivated
leñera añadida	Phrase
violín	Derivative
cresta	Unmotivated
jardín	Derivative
tórtola	Phrase
taza	Phrase
taza	Unmotivated
taza	Phrase
montón	Derivative
untuoso una bola	Phrase
puñado	Derivative
guisantes	Phrase
burrita	Derivative
estrella	Derivative
problema	Derivative
cementerio	Derivative
clavo	Phrase
clavo	Derivative
potrillo	Derivative
cuál es tu punto vulnerable	Phrase
varita	Unmotivated
idilio	Unmotivated
tomate	Unmotivated
lengua de	Phrase
unidad	Derivative
si fuera alfiletero	Phrase
hoja acicular	Phrase
cordero	Derivative
pequeña gruta	Phrase
pequeño lago	Phrase
pachón	Phrase
chispa	Phrase
dieta	Unmotivated
pasillo	Derivative
pequeña tienda	Phrase
reunión	Derivative
déficit	Unmotivated
escalón	Derivative
bolso	Phrase
chaqueta	Derivative
bragas	Phrase
copa	Unmotivated
amigo	Unmotivated
estufa	Phrase
canario	Derivative
gota	Unmotivated
humilladero	Derivative
pañuelo	Derivative
caperucita roja	Phrase
tarjeta	Derivative
cepillo	Derivative
pequeña cazuela	Phrase
parece un bosquecillo cualquier otro	Phrase
palo	Phrase
espiga delgada	Phrase
picapleitos	Derivative
sombrero	Derivative
ovillo	Unmotivated
niño	Phrase
niño indigestión anticipada	Phrase
martillo	Derivative
llave	Phrase
pequeña librería	Phrase
libro	Unmotivated
libro	Unmotivated
botón	Phrase
bigote	Derivative
alfombra india	Phrase
saltamontes	Unmotivated
gatillo	Derivative
rueda	Unmotivated
galleta	Derivative
su salita	Phrase
mordisqueando la punta	Phrase
pocillo	Derivative
elevación	Derivative
enseñé la patita	Phrase
veleta	Unmotivated
corona	Phrase
cuenta una moneda	Phrase
cubo	Phrase
capilla	Derivative
vestido primavera y	Phrase
caldero	Derivative
pedacito	Derivative
rincón	Derivative
pescante	Derivative
cabrita	Derivative
nena	Unmotivated
gata	Unmotivated
cochecito	Derivative
robustez de	Phrase
cesto	Unmotivated
canasta	Derivative
escoba	Phrase
caja	Phrase
paisaje	Derivative
sastre	Unmotivated
cuello	Unmotivated
borde	Phrase
paso	Unmotivated
círculo	Phrase
cubito	Unmotivated
conejo	Derivative
tienda	Unmotivated
belleza	Derivative
vaquilla	Derivative
maletín	Derivative
soldado de ametralladoras ocupaba	Phrase
cuchitril	Phrase
pollito	Derivative
putilla fina	Phrase
fresca una flor	Phrase
florecilla	Derivative
café	Unmotivated
índice	Phrase
silicio	Phrase
viena que	Phrase
ala	Unmotivated
cruz	Unmotivated
manía	Derivative
andares muy vistosos pelo	Phrase
cochinillo piel	Phrase
frasco	Unmotivated
perita agua	Phrase
lóbulo	Phrase
lámpara	Derivative
cable	Phrase
comadreja	Phrase
banco	Phrase
tabla voló aires	Phrase
cráneo	Phrase
refrigerador	Derivative
diversión	Phrase
cuello	Unmotivated
cartón	Derivative
quiosco	Phrase
ruinosa avioneta	Phrase
línea	Unmotivated
nota	Unmotivated
cubo	Phrase
barca	Phrase
cesta	Unmotivated
pequeña linterna puesta	Phrase
trampa	Phrase
carita	Unmotivated
carita ansiosa	Phrase
cuchara usé	Phrase
venía desde zinkensdamm	Phrase
meñique	Phrase
mariscal campo	Phrase
piernotas más duras	Phrase
madre	Unmotivated
tu madre	Phrase
osito	Unmotivated
espada corta	Phrase
tesoro	Derivative
bebé	Phrase
joven	Phrase
rapaz con	Phrase
regurgitando leche	Phrase
molino	Phrase
monjecillo	Derivative
ayuda	Derivative
motos	Unmotivated
sesos	Unmotivated
nube	Phrase
cadáver	Phrase
hermano menor fue	Phrase
hombrecillo	Derivative
hombrecillo	Derivative
palacete	Derivative
ratón	Derivative
mi mamita	Phrase
cuartucho	Derivative
sitio	Phrase
propiedades ya verás	Phrase
pelota	Unmotivated
lavabo pequeñísimo y descascarillado	Phrase
pueblo	Phrase
placita	Derivative
luna	Unmotivated
médula	Derivative
muerte	Unmotivated
reja	Phrase
prostituta	Derivative
hilo	Phrase
pernil	Phrase
nariz	Unmotivated
nariz respingada	Phrase
libreta	Derivative
novedad	Derivative
etiqueta	Derivative
recipiente químico por última	Phrase
camilla	Derivative
bocanada	Derivative
lámina	Derivative
imagen	Unmotivated
rabo	Phrase
hoguera	Derivative
soldadito	Derivative
ventanilla	Derivative
comisaría	Derivative
altarcillo	Derivative
mono	Phrase
soga	Unmotivated
burro	Derivative
octavo egb	Phrase
abordó una persona	Phrase
islote	Derivative
oveja	Unmotivated
nuez moscada	Phrase
perro	Unmotivated
fajo	Derivative
muñeca	Phrase
muñeco	Phrase
dueña	Derivative
papelito	Derivative
parque	Phrase
grupito	Derivative
manera	Derivative
piedra	Unmotivated
madriguera	Phrase
perro	Unmotivated
michino	Phrase
fortalezas hechas	Phrase
botones que	Phrase
píldora	Derivative
tomate	Phrase
abandonaron descampado	Phrase
– menudo saque hija –	Phrase
moneda	Phrase
plataforma	Phrase
mapa	Phrase
filete de	Phrase
surgía una llamita	Phrase
llama	Phrase
capa	Unmotivated
calor	Unmotivated
copa	Unmotivated
habitación	Derivative
habitación	Derivative
casilla	Derivative
tizón lo clavan	Phrase
estante	Derivative
mitad	Phrase
cojín	Phrase
cenicero los que hay en las tabernas	Phrase
ceniza	Derivative
pimpollo	Derivative
viajero extraviado	Phrase
polvo	Unmotivated
hilo de	Phrase
banderín	Derivative
alférez	Phrase
cerdito	Derivative
lluvia	Phrase
barbera	Derivative
vigilaré mi principito	Phrase
water	Unmotivated
tabla	Phrase
trinchando pechuga	Phrase
anillo	Unmotivated
dedo	Phrase
hilillo de	Phrase
varilla	Derivative
vigilia fabricaba minúsculas piezas	Phrase
ropero	Derivative
carta	Unmotivated
opúsculo	Phrase
pajarito	Derivative
perrito aguas	Phrase
atril	Phrase
punto	Unmotivated
merengue	Unmotivated
bolsita	Derivative
sarampión	Phrase
pareja	Derivative
salchichita	Derivative
pequeño navío	Phrase
pluma	Phrase
silbato	Derivative
letra	Unmotivated
servir puerros	Phrase
canción	Unmotivated
raya y	Phrase
amigo	Unmotivated
mitad	Unmotivated
media hora	Phrase
percha	Phrase
bulto	Unmotivated
familia	Unmotivated
gente	Phrase
romance	Phrase
mordaza	Phrase
espacio	Unmotivated
mano	Unmotivated
aguja	Phrase
pez	Unmotivated
lechuga	Phrase
estanque	Unmotivated
caña no fallaba	Phrase
recuadro	Derivative
plantita estiraba	Phrase
macho	Phrase
hembra	Phrase
ambulancia	Derivative
tal	Unmotivated
punzón picar	Phrase
chuleta preparada	Phrase
vástago	Derivative
semilla	Derivative
enfermera	Phrase
bodegón cebollas	Phrase
vaso	Phrase
cristal de estrella	Phrase
cristal	Derivative
resquicio	Derivative
grupo	Phrase
mancha	Unmotivated
elfo	Phrase
de música	Phrase
señorita	Derivative
nota dominical	Phrase
pequeño diccionario	Phrase
palabra	Unmotivated
palabra	Unmotivated
sol	Phrase
menudo bromista está hecho	Phrase
haz	Phrase
estatuilla	Derivative
grajo	Derivative
animador	Derivative
pequeña luna	Phrase
bendito sea viejo hobbit	Phrase
viejecillo	Derivative
viejecita	Derivative
pásame un muslito de pollo	Phrase
tarima	Unmotivated
web métodos	Phrase
máquina	Unmotivated
árbol	Phrase
árbol navidad	Phrase
pequeña costra	Phrase
tío	Phrase
fuente	Phrase
modesto estudiante	Phrase
cinta	Unmotivated
movedizo	Derivative
cita	Unmotivated
pequeña figura	Phrase
serenata	Derivative
puesto	Unmotivated
transparente coloqué	Phrase
consígueme hojas	Phrase
refugio	Phrase
tejadillo	Derivative
dedo medio	Phrase
aguja	Phrase
fragmento	Derivative
zapato	Unmotivated
mesa	Phrase
mesita	Unmotivated
veía un escabel sobre	Phrase
tipo era endeble	Phrase
encontrar capilla sintoísta	Phrase
jersey	Unmotivated
toda basura hay	Phrase
vela	Unmotivated
vela	Phrase
lucecita	Derivative
cambio	Unmotivated
hijo	Derivative
tamiz	Unmotivated
lechuza	Phrase
pastilla	Derivative
cuadro	Phrase
plato	Unmotivated
danza	Unmotivated
papá	Unmotivated
mi padre	Phrase
taxi	Derivative
becerro	Derivative
tía	Unmotivated
tía	Phrase
titular	Derivative
hermoso juguete	Phrase
camiseta	Derivative
pequeño es ayuda	Phrase
triangulito adhesivo enganchado	Phrase
caja	Phrase
cagueta dijo que dispensase	Phrase
carita	Unmotivated
criatura	Phrase
palillo	Derivative
bandeja	Derivative
riachuelo	Derivative
cuerpo	Unmotivated
guinda	Unmotivated
estábamos nerviosísimas pato pobre ángel	Phrase
servilleta	Derivative
carbono	Derivative
callejón	Derivative
paquete	Phrase
manojo	Phrase
cilindro	Unmotivated
guerras	Unmotivated
vainilla	Derivative
viudita nueva	Phrase
curita	Unmotivated
pobre verso huérfano	Phrase
pueblo	Unmotivated
fiesta	Unmotivated
tenedor	Derivative
tarjeta	Derivative
pelo	Phrase
peonza	Derivative
inmutó ni una ola	Phrase
sola hebra	Phrase
chincheta	Derivative
tren	Unmotivated
vodka	Derivative
hidrógeno	Derivative
puerta	Unmotivated
cima	Phrase
cima	Phrase
sonsonete	Phrase
arruga	Derivative
humorista	Derivative
sino una salchichita	Phrase
muestra	Phrase
barandilla	Derivative
libélula	Phrase
cuerda	Phrase
paquete	Phrase
vagoneta embistió	Phrase
tapa	Phrase
cosa	Unmotivated
corona	Phrase
rama	Phrase
liebre bastara	Phrase
tapadera	Derivative
cariño	Derivative
ladrón	Derivative
signo	Unmotivated
marca	Unmotivated
pico	Unmotivated
espejo	Phrase
grano de	Phrase
grano	Unmotivated
germen de	Phrase
vallizuelo	Derivative
risita	Unmotivated
martes	Unmotivated
mueca	Phrase
negras supersticiones	Phrase
diadema	Phrase
cofia	Unmotivated
gorra	Unmotivated
negrito	Derivative
artículo	Unmotivated
líneas describiendo	Phrase
hombrecillo	Derivative
semilla viviente mandíbula en mandíbula	Phrase
boceto	Unmotivated
taco de	Phrase
perra	Derivative
nariz	Unmotivated
pieza	Phrase
importe	Derivative
partícula	Derivative
orden	Unmotivated
pinche	Unmotivated
rímel por delante	Phrase
rábanos	Derivative
correa	Phrase
cadena	Phrase
torpe	Unmotivated
trozo	Derivative
punta	Unmotivated
resorte	Derivative
mazo	Phrase
etiqueta	Derivative
cachorro	Derivative
taza	Phrase
pañuelo	Derivative
cuaderno	Phrase
costurera	Derivative
cuerda	Phrase
judiíto pequeño	Phrase
escalera	Derivative
clasificación	Derivative
esposas	Phrase
mujer chiquita	Phrase
broma	Unmotivated
intentaba realizar pequeña broma	Phrase
canalón sangre	Phrase
volvía un párvulo	Phrase
corpiño	Phrase
