lesbian	Phrase
ampoule	Derivative
angel	Phrase
some beautiful little girl	Phrase
car	Unmotivated
truck	Unmotivated
grandmother	Compound
package	Derivative
pack	Unmotivated
wake-up call	Phrase
box of	Phrase
box	Unmotivated
arbor	Phrase
idiot	Unmotivated
her pad	Phrase
fool	Unmotivated
his haunches	Phrase
loaf	Unmotivated
storm	Unmotivated
cousin	Unmotivated
brother	Unmotivated
wood louse out	Phrase
whetstone	Compound
booklet	Derivative
gate	Unmotivated
drum	Unmotivated
hat	Unmotivated
crop	Unmotivated
steer	Phrase
apartment	Derivative
delicate little thing set	Phrase
last ounce	Phrase
belly	Derivative
small sign attached gatepost	Phrase
path	Unmotivated
cottage	Derivative
vindictive set	Phrase
coolness	Derivative
little boy	Phrase
chap	Unmotivated
little chap has	Phrase
bloke	Unmotivated
cluster	Phrase
sandwich	Phrase
tuft of	Phrase
security	Derivative
box	Unmotivated
poor thing	Phrase
poor thing	Phrase
moment	Unmotivated
moment	Unmotivated
little wrinkle	Phrase
cigar	Derivative
gypsies	Derivative
tums	Unmotivated
rivet at the bottom where started	Phrase
trace anywhere	Phrase
tiny scrap	Phrase
giftie	Derivative
with plate	Phrase
strip	Unmotivated
some trifle	Phrase
little refuge	Phrase
sweetiepie	Derivative
pool	Unmotivated
soul	Unmotivated
door	Phrase
yard	Phrase
dynamics	Derivative
lady	Derivative
piece	Unmotivated
child	Unmotivated
this comedy prettily	Phrase
performance	Derivative
girl	Unmotivated
whore	Unmotivated
girl	Unmotivated
girl	Unmotivated
old man	Phrase
grandfather	Compound
great-grandfather	Compound
work	Unmotivated
next day	Phrase
house	Unmotivated
jug	Phrase
figure	Unmotivated
formula encompassed	Phrase
old man up	Phrase
used that joke before	Phrase
ragamuffin variety	Phrase
rubber band	Phrase
cloth	Unmotivated
voice	Unmotivated
simpleton	Derivative
aluminium	Unmotivated
motive	Unmotivated
shoot	Unmotivated
flower bed	Phrase
place	Unmotivated
hour	Unmotivated
his watch	Phrase
cosy comfort	Phrase
then this good old man	Phrase
pigeon	Unmotivated
girl	Unmotivated
heat	Unmotivated
housewife	Compound
teahouse little pub	Phrase
publishing	Unmotivated
violin	Unmotivated
comb	Unmotivated
garden	Unmotivated
dove	Unmotivated
cup	Unmotivated
cup	Unmotivated
cup	Phrase
pile of	Phrase
nugget of	Phrase
handful of	Phrase
peas	Unmotivated
goose	Unmotivated
little star	Phrase
hook	Unmotivated
cemetery	Derivative
nail	Unmotivated
nail	Phrase
foal	Unmotivated
detail	Unmotivated
wand	Unmotivated
scene has now reached its high point	Phrase
apple	Derivative
tongue	Unmotivated
unit	Unmotivated
satisfactory pincushion	Phrase
leaves	Unmotivated
lamb	Phrase
cave	Unmotivated
pool	Unmotivated
dachshund	Phrase
spark	Unmotivated
diets	Unmotivated
passage might do	Phrase
shop	Unmotivated
meeting	Unmotivated
deficit	Derivative
step	Unmotivated
purse	Unmotivated
jacket	Derivative
panties	Unmotivated
cup	Unmotivated
friend	Unmotivated
stove	Unmotivated
could a canary	Phrase
drop of	Phrase
chapel	Unmotivated
handkerchief	Compound
little riding hood	Phrase
card	Unmotivated
toothbrush	Phrase
small saucepan a	Phrase
sweet-smelling bush	Phrase
stick	Unmotivated
head of	Phrase
was his way jam	Phrase
hat	Unmotivated
ball of	Phrase
little boy	Phrase
little kid	Phrase
hammer	Phrase
key	Derivative
books shelves a	Phrase
book	Unmotivated
book	Unmotivated
button	Unmotivated
moustache	Unmotivated
carpet	Unmotivated
grasshopper	Compound
trigger	Phrase
circle	Derivative
cake	Unmotivated
pollination chamber	Phrase
end of his	Phrase
teapot	Compound
little knoll	Phrase
baby donkey	Phrase
weathervane which	Phrase
of metal-the ferrule-is	Phrase
his pocket bead	Phrase
cube	Unmotivated
church	Unmotivated
suit	Unmotivated
cauldron	Compound
piece of	Phrase
corner of	Phrase
box	Unmotivated
goat	Unmotivated
young goat	Phrase
cat	Unmotivated
baby carriage	Phrase
tough weave indeed	Phrase
basket	Unmotivated
basket	Unmotivated
brush	Unmotivated
box	Unmotivated
landscape	Compound
tailor	Unmotivated
neck	Unmotivated
slice of	Phrase
step	Unmotivated
circle	Derivative
cube milkless victory	Phrase
rabbit	Unmotivated
shop	Unmotivated
beauty	Derivative
person will keep alive a young cow	Phrase
suitcase	Compound
machine gunner	Phrase
room	Unmotivated
chicken	Unmotivated
slut	Derivative
flower	Unmotivated
flower	Unmotivated
coffee	Unmotivated
forefinger	Derivative
silicon	Unmotivated
chair	Unmotivated
valve	Unmotivated
cross	Unmotivated
hobby	Derivative
coat	Unmotivated
wrinkle a	Phrase
bottle	Derivative
treat	Unmotivated
lobe	Unmotivated
lamp	Unmotivated
rope	Unmotivated
weasel	Phrase
bench	Unmotivated
bar	Unmotivated
skull	Phrase
refrigerator	Derivative
thing	Unmotivated
his collar	Phrase
cardboard	Compound
stately home evaporated with	Phrase
propped aeroplane up	Phrase
line	Unmotivated
note	Unmotivated
trenching tool	Phrase
boat	Unmotivated
meaning model boat	Phrase
little lantern set	Phrase
trap	Phrase
face	Unmotivated
face	Unmotivated
spoon	Unmotivated
swiveling top	Phrase
little finger	Phrase
marshal	Phrase
meat	Unmotivated
mother	Unmotivated
mother	Unmotivated
teddy bear	Phrase
sword	Unmotivated
sweetheart	Compound
baby	Derivative
youngster	Unmotivated
young man	Phrase
milk	Unmotivated
grinder	Derivative
young novice has	Phrase
aid	Unmotivated
whirr motor	Phrase
brain	Unmotivated
cloud	Unmotivated
corpse	Unmotivated
lopsided crippled set	Phrase
little man	Phrase
little man	Phrase
lodge	Unmotivated
mouse	Unmotivated
your mamma probably	Phrase
little room	Phrase
place	Unmotivated
flammable possessions	Phrase
ball	Unmotivated
little washing-stand	Phrase
town	Unmotivated
square	Unmotivated
round moon rolled	Phrase
marrow inside	Phrase
death knell	Phrase
spanned rack	Phrase
whore	Unmotivated
thread	Unmotivated
of the legs	Phrase
nose	Unmotivated
nose	Unmotivated
notebook	Compound
news	Unmotivated
non-reusable container	Phrase
window-washer stuff	Phrase
stretcher	Phrase
cloud	Unmotivated
slice	Unmotivated
picture	Unmotivated
tail	Unmotivated
fire	Unmotivated
soldier	Unmotivated
window	Unmotivated
precinct	Derivative
little altar	Phrase
monkey	Derivative
noose tighter	Phrase
little donkey	Phrase
8 horse closer	Phrase
person	Unmotivated
island	Compound
sheep	Unmotivated
nut to crack	Phrase
creep	Unmotivated
deck	Unmotivated
puppet	Unmotivated
marionette	Phrase
wife	Unmotivated
paper	Unmotivated
little park	Phrase
bunch	Unmotivated
hunk of	Phrase
stone	Unmotivated
site	Unmotivated
dog	Unmotivated
little dog skipped after	Phrase
place	Unmotivated
busboy	Derivative
pill	Unmotivated
vivid blush	Phrase
place	Unmotivated
straw floating	Phrase
thin tin	Phrase
platform	Compound
map	Unmotivated
slice of	Phrase
little flame	Phrase
flame	Unmotivated
mantle	Derivative
relief	Unmotivated
cup	Unmotivated
room	Unmotivated
room	Unmotivated
square	Unmotivated
two cents	Phrase
shelf	Phrase
half of	Phrase
cushion	Unmotivated
ash-trays where you touch	Phrase
ash pulverized	Phrase
you were a bud	Phrase
wanderer touched little	Phrase
powder	Unmotivated
stream of	Phrase
flag	Unmotivated
sergeant major	Phrase
pig	Unmotivated
shower of	Phrase
bottom	Unmotivated
prince realm	Phrase
board	Unmotivated
toilet seat	Phrase
breasts	Unmotivated
ring	Unmotivated
finger	Derivative
strip of	Phrase
stick	Unmotivated
lingerie	Derivative
chest of drawers	Phrase
letter	Unmotivated
3v2 volume	Phrase
bird that has	Phrase
poodle	Derivative
lectern	Unmotivated
all your philosophizing	Phrase
twelve-year-old flame	Phrase
withdraws a small bag made	Phrase
measles	Unmotivated
couple	Derivative
couple	Derivative
steamer	Derivative
feather	Unmotivated
whistle	Derivative
letter	Unmotivated
of leeks	Phrase
song	Unmotivated
parting	Unmotivated
malignant little friend	Phrase
half of	Phrase
half an hour	Phrase
hanger	Phrase
bundle	Derivative
family	Derivative
people	Derivative
romance	Unmotivated
gag on	Phrase
there a level space	Phrase
hand	Unmotivated
hand	Unmotivated
fish	Derivative
right rain	Phrase
pond	Unmotivated
rod and his ferule were seldom idle	Phrase
box	Unmotivated
plant	Unmotivated
male	Derivative
female	Derivative
ambulance	Phrase
point intersection	Phrase
ice pick	Phrase
pig	Unmotivated
young sapling	Phrase
seed	Unmotivated
sister	Unmotivated
cellar	Unmotivated
glass	Unmotivated
glass	Unmotivated
glass	Unmotivated
space conceivably	Phrase
group of	Phrase
spot of	Phrase
elf	Phrase
window	Unmotivated
young lady	Phrase
post	Unmotivated
got out dictionary	Phrase
word	Unmotivated
word	Unmotivated
sun	Unmotivated
sneering	Unmotivated
sheaf	Phrase
statue of	Phrase
woodpecker	Compound
heart	Unmotivated
crescent of	Phrase
old percy	Phrase
old man	Phrase
old woman	Phrase
leg	Unmotivated
platform	Compound
provides facilities help	Phrase
safety razor	Phrase
tree	Unmotivated
tree	Unmotivated
at a scab on a dirty	Phrase
uncle	Derivative
mountain stream dressed shabbily if tidily	Phrase
student	Derivative
ribbon	Unmotivated
flock	Unmotivated
tryst	Unmotivated
figure	Unmotivated
history-making serenade	Phrase
stall	Unmotivated
rack	Unmotivated
sense	Unmotivated
shelter	Unmotivated
sunshade which	Phrase
people	Derivative
needle	Derivative
sliver of	Phrase
slipper	Derivative
table	Derivative
table	Derivative
stool there	Phrase
wizened fellow	Phrase
sanctuary	Derivative
sweater	Derivative
mess	Unmotivated
candle	Derivative
palmer houses portiered	Phrase
light	Unmotivated
room is	Phrase
son	Unmotivated
tea-strainer	Compound
screech-owl	Compound
tablet	Derivative
table	Derivative
plate	Unmotivated
dance	Unmotivated
father	Unmotivated
father	Unmotivated
taxi	Unmotivated
calf	Unmotivated
woman	Unmotivated
auntie	Derivative
headline	Compound
trifle	Derivative
t-shirt	Compound
little bit	Phrase
triangle of	Phrase
box	Unmotivated
woodbox meantime	Phrase
face	Unmotivated
thing	Unmotivated
thin chap	Phrase
tray	Derivative
stream	Unmotivated
body	Derivative
top	Unmotivated
poor little creature	Phrase
napkin	Derivative
carbon	Unmotivated
end	Unmotivated
bundle	Derivative
bundle	Derivative
cylinder	Derivative
wars	Unmotivated
vanilla raisins	Phrase
widow more easily	Phrase
priest	Unmotivated
rhyme	Unmotivated
village	Unmotivated
party	Derivative
fork	Unmotivated
card	Unmotivated
hair	Unmotivated
wolfling has come back	Phrase
ripple	Derivative
thread upon	Phrase
small flag	Phrase
train	Unmotivated
vodka	Derivative
hydrogen	Unmotivated
gate	Unmotivated
top of the	Phrase
top of the	Phrase
hand organ	Phrase
wrinkle	Derivative
witty guy	Phrase
sausage instead	Phrase
sample	Derivative
up balcony tracing	Phrase
dragon fly	Phrase
string	Unmotivated
sheaf of	Phrase
stretcher	Derivative
lid	Phrase
thing	Unmotivated
chocolate ring	Phrase
twig	Phrase
pit of theirs	Phrase
front	Unmotivated
honey	Derivative
thief	Unmotivated
mole	Derivative
mole	Derivative
beak	Unmotivated
mirror	Unmotivated
grain of	Phrase
was a grain	Phrase
embryo	Unmotivated
small valley	Phrase
grin	Unmotivated
until tuesday evening	Phrase
grin	Unmotivated
ornery lot	Phrase
moment later by fox-fur band	Phrase
bonnet which	Phrase
primer-black cap	Phrase
quite coony baby	Phrase
article	Derivative
this little paragraph sir	Phrase
little man	Phrase
shuttle	Derivative
sketch	Unmotivated
square of	Phrase
bitch	Unmotivated
nose	Unmotivated
component	Derivative
amount	Derivative
particle of	Phrase
order	Unmotivated
little clerk	Phrase
mascara run	Phrase
radishes	Unmotivated
thong	Unmotivated
chain	Unmotivated
windburned man	Phrase
piece of	Phrase
tip of	Phrase
screw	Unmotivated
stack of	Phrase
label	Unmotivated
puppy	Derivative
cup	Phrase
handkerchief	Compound
notebook	Compound
seamstress	Derivative
string	Unmotivated
pimply little jew he used to be	Phrase
ladder	Unmotivated
ladder	Unmotivated
cuffs	Unmotivated
woman walked	Phrase
joke	Unmotivated
hoax	Unmotivated
groove	Unmotivated
schoolboy	Derivative
bodice	Unmotivated
