lesbienne pas vrai	Phrase
ampoule remplie	Phrase
ange	Unmotivated
angelot	Derivative
voiture	Derivative
camionnette	Derivative
grand-mère	Derivative
paquet	Derivative
son sac à dos	Phrase
réveil	Phrase
caisse	Phrase
caisse	Phrase
tonnelle	Derivative
débile	Unmotivated
bloc papier	Phrase
petite folle	Phrase
moquette	Derivative
gâteau	Derivative
orage	Phrase
cousin	Unmotivated
petit frère	Phrase
insecte	Phrase
pierre noire	Phrase
toujours pages disaient quelque chose	Phrase
porte	Derivative
tambour	Unmotivated
chapeau melon	Phrase
cravache	Phrase
taurillon vint	Phrase
immeuble	Unmotivated
air	Unmotivated
retenir mes derniers restes familiaux	Phrase
ventre	Phrase
étiquette	Derivative
sentier	Phrase
chaumière	Phrase
traînent gens	Phrase
fraîcheur	Derivative
petit garçon	Phrase
type	Unmotivated
petit bonhomme a sauvée	Phrase
type	Unmotivated
couronnée un bouquet	Phrase
sandwich	Phrase
petite touffe	Phrase
sécurité dont	Phrase
boîte	Unmotivated
pauvre	Phrase
pauvre	Phrase
moment	Unmotivated
instant	Phrase
mignon	Derivative
petit cigare	Phrase
gitane	Unmotivated
douceur	Phrase
clou	Unmotivated
tout petit lambeau	Phrase
nouvelle fit renaître un frêle	Phrase
cadeau	Derivative
plaque éinaillée	Phrase
bodruche	Unmotivated
gâteau	Derivative
petit repaire déplaît	Phrase
chérie	Phrase
piscine	Unmotivated
son âme confiante	Phrase
portière	Phrase
cour	Phrase
dynamisme	Derivative
dame mûre	Phrase
pièce	Unmotivated
enfant	Phrase
retour	Unmotivated
cinéma	Unmotivated
petite fille	Phrase
pute	Unmotivated
servante	Derivative
petite fille	Phrase
pépé	Phrase
grand-père	Derivative
arrière-grand-père	Derivative
pour préparer coup	Phrase
lundi fut journée	Phrase
château	Derivative
cruche	Phrase
personnage	Derivative
formule	Phrase
petit papa	Phrase
osée	Unmotivated
gouape	Unmotivated
pastille un fil caoutchouc	Phrase
tissu exposé	Phrase
voix	Unmotivated
serin bêtasse	Phrase
aluminium	Unmotivated
qualité intrinsèque	Phrase
rejeton légitime	Phrase
sécheresse qui saccagea carré	Phrase
nid rapprochant	Phrase
minute	Unmotivated
sa montre	Phrase
commode	Unmotivated
comprit très bien ce petit chéri	Phrase
colombe gris cendré a éventé	Phrase
petite fille	Phrase
chaleur	Derivative
quelle admirable maîtresse de	Phrase
salle où	Phrase
étrange troupe	Phrase
violon minuscule	Phrase
peigne paraîtrait minuscule	Phrase
jardin	Unmotivated
colombe	Phrase
tasse	Phrase
tasse	Unmotivated
tasse	Phrase
pile de	Phrase
motte	Derivative
poignée	Phrase
petit pois	Phrase
vois une petite femelle insignifiante	Phrase
étoile	Phrase
y a un hic	Phrase
cimetière	Derivative
clou	Phrase
girofle	Phrase
pouliche	Unmotivated
détail de	Phrase
baguette	Derivative
tableau la idéale atteint la perfection	Phrase
tomate	Phrase
langue la	Phrase
unité	Unmotivated
pelote recroqueville	Phrase
sentit une fine aiguille lui choir	Phrase
agnelet	Derivative
grotte	Derivative
lac	Phrase
lévrier	Phrase
petite étincelle	Phrase
régime	Unmotivated
sur mètres	Phrase
parfumerie un petit	Phrase
sommet	Derivative
déficit	Phrase
marche tout près	Phrase
sac	Unmotivated
sa veste	Phrase
culotte	Derivative
gobelet	Derivative
tes copains scout	Phrase
poêle	Unmotivated
canari -il	Phrase
goutte	Derivative
chapelle	Derivative
petit mouchoir	Phrase
petit chaperon rouge	Phrase
vide	Unmotivated
brosse	Phrase
petite casserole	Phrase
buisson	Derivative
bâton	Derivative
petit épi	Phrase
machination	Derivative
petit chapeau	Phrase
peloton laine	Phrase
gamin	Phrase
petit gosse	Phrase
marteau	Derivative
clef	Phrase
minimum une petite bibliothèque	Phrase
livre	Unmotivated
petit livre	Phrase
bouton	Derivative
moustache	Unmotivated
tapis	Unmotivated
sauterelle	Derivative
robinet	Derivative
rond	Phrase
scones beurrés servis par	Phrase
chambrette	Derivative
bout	Unmotivated
petit pot	Phrase
coteau	Derivative
forme pour une	Phrase
girouette	Derivative
couronne ducale	Phrase
perle lui furent donnés	Phrase
morceau	Derivative
petite église	Phrase
tailleur	Derivative
chaudron	Derivative
petit morceau	Phrase
coin	Unmotivated
siège	Phrase
chèvre	Unmotivated
cabri	Phrase
mot chat	Phrase
landau	Unmotivated
nature	Unmotivated
panier	Phrase
panier	Phrase
bâton dénudé	Phrase
boîte	Phrase
soldat reconnut un jour dans cette peinture un paysage	Phrase
tailleur	Derivative
col	Phrase
morceau pain	Phrase
pas	Phrase
anneau	Derivative
quignon un carré	Phrase
lapin	Phrase
boutique	Phrase
beauté	Phrase
barbe aussi sera enlevée	Phrase
mallette	Derivative
mitrailleur vient	Phrase
réduit minuscule	Phrase
poussin	Unmotivated
putain a donc accordé ses	Phrase
fleur	Unmotivated
petite fleur	Phrase
petit café	Phrase
son index	Phrase
silicium	Phrase
fauteuil	Phrase
petite aile	Phrase
croix	Phrase
petit cheval	Phrase
fourrure	Phrase
hobbit envelopper un petit	Phrase
flacon	Derivative
friandise	Phrase
lobe	Phrase
lampe	Phrase
cable entourant lâchement	Phrase
belette soient mêmes	Phrase
banc	Phrase
placé barre	Phrase
crâne	Unmotivated
frigo	Derivative
gigantesque fumisterie	Phrase
col	Unmotivated
carton	Derivative
pavillon grouillait cobras	Phrase
avion	Derivative
ligne	Unmotivated
feuille	Derivative
seau	Derivative
barque	Unmotivated
petite embarcation	Phrase
furent suspendues à toutes ses branches	Phrase
piège	Phrase
visage	Derivative
visage trempé	Phrase
tenant sa cuillère	Phrase
gyrophare apportait	Phrase
petit doigt	Phrase
maréchal	Phrase
viande	Unmotivated
sa mère fût si	Phrase
petite maman	Phrase
en peluche	Phrase
épée	Unmotivated
chérie	Derivative
bébé	Phrase
petit jeune	Phrase
petit jeune homme	Phrase
mon petit lait chaud	Phrase
moulin	Phrase
-ci notre moinillon	Phrase
advienne aide	Phrase
motos	Unmotivated
linotte avec	Phrase
moindre nuage	Phrase
cadavre	Unmotivated
petit infirme	Phrase
petit homme	Phrase
petit homme	Phrase
château	Derivative
souris	Phrase
maman vont bientôt claquer	Phrase
pièce aussi	Phrase
place	Unmotivated
saint-frusquin	Derivative
balle	Derivative
lavabo écaillé absolument minuscule	Phrase
village	Phrase
placette	Derivative
lune	Phrase
moelle	Derivative
glas	Unmotivated
grille	Derivative
prostituée	Phrase
fil	Phrase
ta patte	Phrase
petit nez	Phrase
petit nez	Phrase
carnet	Derivative
nouveauté	Phrase
générateur aérosol	Phrase
petit matériel	Phrase
civière	Phrase
nuage	Phrase
petit détour	Phrase
image	Unmotivated
queue	Phrase
peu feu	Phrase
petit soldat	Phrase
vitre	Phrase
district	Phrase
petit autel	Phrase
de singe était assise	Phrase
formant nœud coulant	Phrase
petit âne	Phrase
huit allongés	Phrase
personnage	Derivative
îlot	Derivative
brebis	Unmotivated
noisette	Derivative
valet de ferme	Phrase
liasse de	Phrase
poupée	Phrase
marionnette	Derivative
petite dame	Phrase
papier	Derivative
square	Unmotivated
partie	Unmotivated
mira restât une frange	Phrase
silex	Unmotivated
réchauffer petit lit	Phrase
chien	Unmotivated
chien	Unmotivated
petit bunker en	Phrase
groom	Unmotivated
pilule	Unmotivated
pivoine	Phrase
planette	Derivative
surveillez vos bouchons	Phrase
vibra une plaque	Phrase
plate-forme	Derivative
carte	Phrase
tranche	Phrase
ses yeux	Phrase
flamme	Phrase
son mantelet	Phrase
portrait	Unmotivated
gobelet	Derivative
chambre	Unmotivated
pièce minuscule avec entre-deux	Phrase
case	Phrase
bout	Phrase
étagère	Derivative
moitié	Phrase
petit oreiller	Phrase
voir remettre le cendrier	Phrase
fines particules rejetées par	Phrase
boutons hors ceux	Phrase
voyageur égaré présentiez aucun intérêt	Phrase
poudre	Phrase
filet	Derivative
drapeau	Derivative
mon adjudant-chef	Phrase
cochon	Derivative
pluie	Phrase
point	Unmotivated
prince	Phrase
siège	Unmotivated
siège de toilettes	Phrase
mais vous avez de tout petits seins	Phrase
bague	Phrase
petit doigt	Phrase
filet	Derivative
mince une tige saule	Phrase
sous-vêtements	Derivative
commode	Phrase
lettre	Phrase
opuscule	Unmotivated
oisillon	Derivative
petit loulou	Phrase
pupitre	Phrase
couleur	Derivative
ta bouche présent	Phrase
petit sac contenant	Phrase
rougeole	Phrase
couple	Phrase
couples tout	Phrase
vapeur	Derivative
rose	Unmotivated
sifflet retentit suivi	Phrase
lettre c	Phrase
poireau	Derivative
chanson	Derivative
sentier	Unmotivated
copain	Unmotivated
moitié	Unmotivated
demi-heure	Derivative
cintre	Unmotivated
ballot	Derivative
petite famille	Phrase
peuple	Unmotivated
petit roman	Phrase
son bâillon	Phrase
il y avait un espace plan	Phrase
bras	Unmotivated
aiguille	Derivative
poisson	Derivative
gardon	Derivative
mare	Unmotivated
avait demanda harry déconcerté	Phrase
cadre	Unmotivated
volera -t-elle la pauvre plante	Phrase
mâle	Phrase
femelle	Derivative
ambulance	Phrase
point croisement	Phrase
hachette	Derivative
cochon kolkhoze ils	Phrase
petite pousse	Phrase
graine de cachée	Phrase
petite sœur	Phrase
oignons	Unmotivated
verre	Unmotivated
verre	Unmotivated
verre	Unmotivated
moindre ouverture	Phrase
groupe	Phrase
tache	Unmotivated
elfe	Phrase
niche	Phrase
petite demoiselle	Phrase
colonne	Derivative
lexique franco-français	Phrase
mot	Derivative
mot	Derivative
soleil	Phrase
si moqueur	Phrase
bouquet dansait	Phrase
statue	Unmotivated
geai	Phrase
cœur	Unmotivated
croissant de la	Phrase
vieux bonhomme	Phrase
petit vieillard	Phrase
vieille femme	Phrase
cuisse auriez mangées	Phrase
estrade	Unmotivated
outils	Unmotivated
machine	Unmotivated
sapin	Unmotivated
sapin	Phrase
petite croûte	Phrase
oncle	Unmotivated
fontaine	Phrase
petit étudiant	Phrase
ruban	Phrase
troupeau	Derivative
rendez-vous	Compound
personnage	Derivative
sérénade leur offrant	Phrase
kiosque	Phrase
sa place quittai le	Phrase
seul brin	Phrase
petit auvent	Phrase
rafraîchissements un	Phrase
son majeur	Phrase
aiguille déviée	Phrase
éclats	Phrase
petit soulier	Phrase
table	Phrase
table	Unmotivated
tabouret	Derivative
gnome certes oui	Phrase
chapelle précédée	Phrase
sweat-shirt	Compound
pétaudière	Phrase
bougie	Unmotivated
petite chandelle cire	Phrase
lumière	Derivative
chambrette	Derivative
fils	Unmotivated
tamis	Phrase
chouette	Derivative
cachet	Derivative
tableau	Derivative
assiette	Derivative
petite ronde	Phrase
papa	Unmotivated
mon père	Phrase
taxi	Phrase
ton veau tout descendu	Phrase
tante à	Phrase
tante	Unmotivated
titre	Unmotivated
joli colifichet	Phrase
tee-shirt	Derivative
peu	Phrase
sur portait un triangle	Phrase
vieil écrin contenant	Phrase
caisse posée à côté	Phrase
visage remonté à	Phrase
insecte comprenait	Phrase
houblon	Derivative
plateau	Derivative
ruisseau	Derivative
corps	Unmotivated
cerise	Unmotivated
très pauvre homme sanglota -t-il	Phrase
serviette	Derivative
carbone	Unmotivated
impasse	Derivative
petite boule aurait dû	Phrase
paquet	Derivative
rouleau	Derivative
guerres	Unmotivated
vanille	Derivative
veuve	Phrase
petit curé	Phrase
couplet inintelligible	Phrase
village	Unmotivated
soirée	Derivative
fourchette	Derivative
carte	Unmotivated
cheveu	Phrase
moindre louveteau vint -il	Phrase
vague	Unmotivated
araignées les subtiles laissent fil trop	Phrase
fanion	Derivative
train	Unmotivated
vodka	Phrase
hydrogène	Compound
porte	Derivative
sommet	Derivative
sommet	Derivative
rouet	Derivative
pli	Phrase
taquin	Unmotivated
saucisse	Unmotivated
échantillon	Derivative
petit péristyle rien	Phrase
libellule	Phrase
ficelle	Derivative
liasse	Phrase
petit chariot	Phrase
couvercle	Phrase
chose	Phrase
couronne	Phrase
branche	Phrase
pucelle	Derivative
couverture	Derivative
ma chérie	Phrase
chapardeur	Derivative
type signe	Phrase
grain beauté	Phrase
bec	Unmotivated
miroir	Phrase
grain	Phrase
grain	Unmotivated
germe	Phrase
vallée	Derivative
sourire voulait	Phrase
mardi	Unmotivated
grimace	Phrase
quel micmac	Phrase
serre-tête	Derivative
coiffe	Phrase
toque bien vissée	Phrase
petit nègre	Phrase
article	Unmotivated
faits divers	Phrase
petit bonhomme	Phrase
navette	Derivative
tracer un dessin comme elle apparaîtrait	Phrase
carré	Unmotivated
chienne	Phrase
museau	Derivative
dispositifs auxiliaires	Phrase
montant	Phrase
parcelle	Derivative
ordre	Unmotivated
petit fonctionnaire	Phrase
quand le mascara coulait avec ses	Phrase
radis	Unmotivated
laisse	Phrase
chaîne	Phrase
courtaud	Phrase
cigare à	Phrase
pointe	Unmotivated
vis nickelée	Phrase
liasse	Phrase
étiquette	Derivative
petit bichon frisé	Phrase
tasse	Phrase
bientôt son mouchoir	Phrase
carnet	Derivative
cousette	Derivative
cordon	Derivative
petit juif	Phrase
échelle	Derivative
classement	Derivative
menottes	Phrase
mignonne	Derivative
plaisanterie	Derivative
bonne humeur générale	Phrase
rainure	Derivative
écolier	Phrase
corsage	Derivative
