Neigungen	Derivative
Ampulle	Unmotivated
Engelchen	Derivative
Engelchen	Derivative
Auto	Unmotivated
Pritschen wagen schon	Phrase
Großmutter	Compound
Paket	Unmotivated
Rucksack	Compound
Weckruf dienen	Phrase
Kisten Aufprallen geplatzt	Phrase
Kasten	Unmotivated
Veranstaltung	Derivative
kleine Idiotin armes versehrt offenlege	Phrase
Reichweite gewesen kein Block wenigstens	Phrase
Närrchen	Unmotivated
die Hocke	Phrase
rundes Brot	Phrase
ein Gewitter	Phrase
Cousin	Unmotivated
Bruder	Unmotivated
Käfer	Unmotivated
hätte einen Stein mitnehmen sollen	Phrase
Seiten insgeheim	Phrase
Pforte	Unmotivated
Blechtrommel	Compound
die Melone	Phrase
die Peitsche	Phrase
junger Stier	Phrase
Wohnung	Derivative
Wesen	Unmotivated
Rest	Unmotivated
Bäuchlein	Compound
Schildchen	Derivative
Weg	Unmotivated
Hütte	Unmotivated
wilder Haufen	Phrase
Kühle	Unmotivated
Junge	Unmotivated
Mann	Unmotivated
reinliche Jüngling	Phrase
Typ	Unmotivated
Gruppe Dorfhäusern genügend Deckung bot	Phrase
ein Sandwich	Phrase
kleines Menschenknäuel	Phrase
Sicherheitsmaßnahmen sind gründlich	Phrase
Briefkasten	Compound
die Arme	Phrase
der Ärmste	Phrase
einen Augenblick	Phrase
Einen Weltaugenblick –	Phrase
winziger Fehler	Phrase
ein Zigarillo	Phrase
Zigeunerinnen	Compound
Praline	Unmotivated
vertraute Nagelkopf	Phrase
Zipfelchen	Derivative
ein Zipfelchen von	Phrase
ein Geschenk	Phrase
Zettel	Unmotivated
schmales rechteckiges Stück weißer Karton darin	Phrase
das Stück Kesselkuchen	Phrase
Nestchen	Derivative
das Herzchen	Phrase
ein Bassin	Phrase
Seele	Unmotivated
die Tür	Phrase
den Hof	Phrase
Dynamik	Derivative
wir junge Dame könnten	Phrase
Teil	Unmotivated
Kind	Unmotivated
mein kleines Theater	Phrase
Schauspiel	Compound
Mädchen	Unmotivated
eine Hure	Phrase
Magd	Unmotivated
Mädchen	Unmotivated
der Großvater	Phrase
Großvater	Compound
Urgroßvater	Compound
Werk	Unmotivated
nächsten Tag	Phrase
Häuschen	Unmotivated
Krug	Unmotivated
Figur	Unmotivated
Formel	Derivative
der Alte	Phrase
kleinen Witzchen sein	Phrase
Sorte munterer Zigeunerbengel	Phrase
das Zopfband	Phrase
den Lappen	Phrase
Stimme	Unmotivated
zweites Dummchen wie gibt	Phrase
Aluminium	Unmotivated
Beweggrund	Compound
Sproß	Unmotivated
das Beet	Phrase
Wohnung	Derivative
Stunde	Unmotivated
die Uhr	Phrase
Kugel schieben	Phrase
Täubchen	Derivative
Täubchen	Derivative
Mädchen	Unmotivated
Hitze	Unmotivated
Hausfrau	Compound
Lokal Stadtbauamt	Phrase
weit voraus eine Gruppe bewaldeter	Phrase
lustige Geigen	Phrase
der Kamm	Phrase
Garten	Unmotivated
Turteltaube	Compound
eine Tasse	Phrase
um ihren behaglich Becher geklammert	Phrase
Tasse	Unmotivated
ein Häufchen	Phrase
Punkt war plötzlich dort Stück neben dem Mittelpunkt glühend	Phrase
eine Handvoll	Phrase
Erbsen	Unmotivated
rechte Gans	Phrase
Sternchen	Derivative
einen Haken	Phrase
Friedhof	Compound
den Nagel	Phrase
den Nagel	Phrase
Getue eines Fohlens	Phrase
ja nur eine ganz kleine Sünde	Phrase
Zauberstab	Compound
ein Idyll	Phrase
ein Apfel	Phrase
Zunge	Unmotivated
Einheit	Derivative
Nadelkissen	Compound
Blätter der	Phrase
Lämmchen	Derivative
kleine Höhle	Phrase
kleiner See	Phrase
ein Dackel	Phrase
Funken	Unmotivated
Ernährung	Unmotivated
Diele genannt	Phrase
Laden	Unmotivated
Treffen	Unmotivated
Defizit	Derivative
eine Stufe	Phrase
Handtasche	Compound
Jäckchen	Derivative
Höschen	Unmotivated
Gläschen ein	Phrase
von irgendeinem Freundchen	Phrase
Petroleumofen	Compound
Kanarienvogel	Compound
Tropfen	Unmotivated
kleine Kapelle	Phrase
ein Taschentuch	Phrase
Rotkäppchen sagte Sofie kopfschüttelnd	Phrase
Karte	Unmotivated
eine Zahnbürste	Phrase
wir Fischkessel	Phrase
Strauch	Unmotivated
Stöckchen	Derivative
gleich einem magren Ährlein	Phrase
Schnürsenkelschleife jedoch	Phrase
Hütchen	Unmotivated
Knäuel	Unmotivated
kleiner Junge	Phrase
Junge	Unmotivated
den Hammer	Phrase
Schlüssel	Unmotivated
das Bücherbord aussieht	Phrase
Buch	Unmotivated
Büchlein	Compound
Knopf auf	Phrase
Schnurrbart	Compound
Teppich	Unmotivated
Stute	Unmotivated
den Hahn	Phrase
Schubkarre	Compound
Scheibchen	Derivative
Kammer	Unmotivated
führte die Spitze	Phrase
Kännchen	Derivative
Hügel	Unmotivated
der Pferdefuß lag	Phrase
Wetterfahne	Compound
eine Krone	Phrase
Perle	Unmotivated
Würfel	Unmotivated
Kirche	Unmotivated
Kostüm	Unmotivated
einen Kessel	Phrase
Stückchen	Derivative
Ecke	Unmotivated
den Bock	Phrase
Ziege	Unmotivated
Teufel herum Zickel	Phrase
Katze	Unmotivated
Kinderwagen	Compound
Wurzel	Unmotivated
einen Korb	Phrase
ein Körbchen	Phrase
Handbesen	Compound
Schachtel	Unmotivated
kleine Landschaft	Phrase
das Tapfere Schneiderlein	Phrase
Schenkelhalsbruch	Compound
eine Scheibe	Phrase
Schritt	Unmotivated
Kreis	Unmotivated
Eßgeschirr voll eines rosagrauen Eintopfes Würfel	Phrase
Kaninchen	Derivative
Laden	Unmotivated
Schönheit	Derivative
sich jeder junge Kuh	Phrase
Koffer	Unmotivated
der Maschinengewehrschütze	Phrase
Krapfen eigentlich ein Verschlag	Phrase
Hühnchen	Derivative
Hürchen	Unmotivated
frisches Gänseblümchen	Phrase
ein Blümchen	Phrase
Kaffee	Unmotivated
Zeigefinger	Compound
um Silicium	Phrase
Lehne schleifte	Phrase
ist wie ein kleiner harter Flügel	Phrase
Kreuz	Unmotivated
Pferdchen	Derivative
das Fell	Phrase
Haut	Unmotivated
Flasche	Unmotivated
Delikatesse	Derivative
Ohrläppchen	Compound
Lampe	Unmotivated
sogar Logleine	Phrase
ein Wiesel	Phrase
Bank	Unmotivated
Latte aufgestapelten Bauholz fehle	Phrase
Schädel	Unmotivated
der Kühlschrank	Phrase
Scherz	Unmotivated
Kragen	Unmotivated
Pappe	Unmotivated
Lusthaus	Compound
diese Spielzeugmaschine	Phrase
Linie	Unmotivated
Zettel	Unmotivated
Schulterblatt	Compound
das Boot	Phrase
Boot	Unmotivated
seinen sämtlichen Zweigen wurden Laternen aufgehängt	Phrase
Falle	Unmotivated
Gesicht	Unmotivated
Gesichtchen	Derivative
der Löffel	Phrase
trug er ein Blaulicht	Phrase
kleinen Finger	Phrase
Marschall	Compound
Fleisch	Unmotivated
Mutter	Unmotivated
Mütterchen	Derivative
Entchenmuster Teddy	Phrase
Schwert	Unmotivated
Liebling	Derivative
das Baby	Phrase
der junge Mann	Phrase
Jüngling	Derivative
Milch	Unmotivated
Mühle	Unmotivated
wiewohl angehende Mönche	Phrase
Notbehelf bleibt	Phrase
Motorräder	Compound
Gehirn	Derivative
Wölkchen	Derivative
Leichnam eines Sperlings	Phrase
stolpernden Schritten	Phrase
Mann	Unmotivated
Männchen	Derivative
Schlößchen	Derivative
Maus	Unmotivated
Mütterchen	Derivative
Zimmer	Unmotivated
Platz	Unmotivated
Habseligkeiten	Compound
den Ball	Phrase
zersprungener Waschtisch	Phrase
Städtchen	Derivative
Platz	Unmotivated
Bellen Hunde	Phrase
das Mark	Phrase
Sterbeglöckchen	Compound
der Raster	Phrase
die Hure	Phrase
Strich	Unmotivated
Beinchen	Derivative
Nase	Unmotivated
zieht das reizende Näschen wieder	Phrase
sein Notizbuch	Phrase
Neuigkeit	Derivative
Behälter	Unmotivated
Werkzeug zusammenzupacken	Phrase
die Bahre	Phrase
Wölkchen	Derivative
kokette Kurve	Phrase
Bild	Unmotivated
Schwanz	Unmotivated
Feuer	Unmotivated
Soldat	Derivative
Fenster	Unmotivated
Bezirk	Derivative
kleinen Altar	Phrase
Äffchen	Unmotivated
Schlinge	Unmotivated
Eselchen	Derivative
Pockenimpfung aufwies	Phrase
Person	Unmotivated
Insel	Unmotivated
ein Schaf	Phrase
Brocken	Unmotivated
der Knecht	Phrase
Paket	Unmotivated
Püppchen	Derivative
eine Holzpuppe	Phrase
Frauchen	Unmotivated
den Zettel	Phrase
Grünanlage	Compound
Clique	Unmotivated
Schaftkappe	Compound
Faustkeil ab	Phrase
n Nickerchen mögen	Phrase
Hund	Unmotivated
Hündchen	Unmotivated
der Unterstand	Phrase
ein Pikkolo	Phrase
Pille bevor	Phrase
eine Pfingstrose	Phrase
Platz	Unmotivated
Schwimmer Angel gerichtet	Phrase
Langdon Minisender	Phrase
Plattform gab	Phrase
Karte	Unmotivated
Scheibe	Unmotivated
Flämmchen	Derivative
Flamme	Unmotivated
Mäntelchen	Derivative
Silberrahmen eingefaßte Foto	Phrase
den Becher	Phrase
Zimmer	Unmotivated
Zimmerchen	Derivative
Feld	Unmotivated
weiteres Scheit Kamin	Phrase
ein prächtiges Regal	Phrase
die Hälfte	Phrase
Kissen	Unmotivated
den Aschenbecher	Phrase
die Flugasche	Phrase
Rosenknospe	Compound
vereinzelter Wanderer	Phrase
das Pulver	Phrase
eine Strähne	Phrase
Fähnchen	Derivative
der Fähnrich	Phrase
Schweinchen	Derivative
Sprühregen	Compound
Podex Popo	Phrase
verhätschelter Prinz	Phrase
das Brettchen	Phrase
ein Schneidebrett	Phrase
Fasanenbrust mit geben	Phrase
den Ring	Phrase
Fingerchen weggedrückt	Phrase
Streifen	Unmotivated
Zauberstab	Compound
triefenden Sachen obendrauf	Phrase
die Kommode	Phrase
ein Briefchen	Phrase
Schrift	Unmotivated
scheues Vögelchen	Phrase
Zeichen Pudel	Phrase
vor dem Podium stehenblieb	Phrase
Punkt	Unmotivated
Goldmäulchen	Compound
Plastikbeutel hoch	Phrase
Masern	Unmotivated
Paar	Unmotivated
Pärchen	Unmotivated
Hausboot	Compound
Feder	Unmotivated
Pfeife	Derivative
Buchstaben	Unmotivated
Schalotten	Unmotivated
Lied	Unmotivated
Scheitel	Derivative
von kleinen Freund	Phrase
Hälfte	Unmotivated
knappe halbe Stunde	Phrase
einen Kleiderbügel	Phrase
Bündel	Unmotivated
Familie	Unmotivated
Leute	Unmotivated
Affäre	Unmotivated
den Knebel	Phrase
kam ein ebenes Stück	Phrase
Hand	Unmotivated
der Zeiger	Phrase
Fisch	Unmotivated
Fisch	Unmotivated
kleine Ententeich	Phrase
Rohrstock	Compound
Kasten	Unmotivated
Pflanze	Unmotivated
das Männchen	Phrase
Weibchen	Derivative
der Krankenwagen	Phrase
der Schnittpunkt	Phrase
das Hackmesser	Phrase
Ferkelchen	Derivative
Sämling	Unmotivated
Samenkorn	Compound
Schwester	Unmotivated
Zwiebelkeller	Compound
Glas	Unmotivated
Glas	Unmotivated
Glassplitter	Compound
Spalt	Unmotivated
Gruppe	Unmotivated
Fleckchen	Derivative
der Elf	Phrase
Kästchen	Derivative
Fräulein	Derivative
Staubwirbel erblickt	Phrase
kleinen Höflichkeitskodex	Phrase
Wort	Unmotivated
Wort	Unmotivated
die Sonne	Phrase
Spötter	Derivative
verschlungen und verzehrt eine Strohgarbe	Phrase
Statue	Derivative
Eichelhäher	Compound
Herz	Unmotivated
Mondsichel	Compound
schau her der Alte hat	Phrase
der Alte	Phrase
alte Frau	Phrase
lutschte an dem Hühnerbein	Phrase
Stufe	Unmotivated
Seite	Unmotivated
Rasierapparat	Compound
den Weihnachtsbaum	Phrase
den Baum	Phrase
wenig Wundschorf darauf	Phrase
Onkel	Unmotivated
zarter weißer Wolkenschleier einzigen Pinselschwung aufgetragen	Phrase
Studentlein	Compound
Bändchen	Unmotivated
eine kleine Herde	Phrase
Treffen	Unmotivated
Gestalt	Unmotivated
Ständchen	Derivative
Stand	Unmotivated
wieder Gestell	Phrase
Grashälmchen	Compound
Dach	Unmotivated
hochgeklappte Verdeck	Phrase
Mittelfinger	Compound
die Nadel	Phrase
Scherbe	Unmotivated
Schuh	Unmotivated
Tisch	Unmotivated
Tischchen	Derivative
Backenzahn	Compound
Handchenvoll	Compound
einen Schrein	Phrase
einen Pullover	Phrase
wo doch Unordnung	Phrase
Kerze	Unmotivated
verkümmertes Kerzlein dieser	Phrase
Licht	Unmotivated
Zimmer	Unmotivated
Sohn	Unmotivated
das Teesieb	Phrase
ein Käuzchen	Phrase
mit Magentablette	Phrase
Tabelle	Unmotivated
einen Teller	Phrase
Tänzchen	Derivative
Väterchen	Unmotivated
Vater	Unmotivated
ein Taxi	Phrase
Kälbchen	Derivative
Tunte	Unmotivated
Tante	Unmotivated
Schlagzeile	Compound
Talmiware	Compound
T-Shirt	Compound
Tasse	Unmotivated
Dreieck	Compound
verschließbares Kästchen	Phrase
rechteckiger Blumenkasten entlanglief	Phrase
Gesicht	Unmotivated
Geschöpf	Derivative
vertrockneter Pfahl	Phrase
Tablett	Unmotivated
Bächlein	Unmotivated
Körper	Unmotivated
eine kleine Kirsche	Phrase
kleine Großmaul	Phrase
eine Serviette	Phrase
Kohlenstoff	Compound
Gasse	Unmotivated
Bündel	Unmotivated
Bündel	Unmotivated
Zylinder	Unmotivated
Kriege	Unmotivated
Vanille	Unmotivated
Witwe	Unmotivated
Priester	Unmotivated
Verse	Unmotivated
Dörflein	Unmotivated
eine Party	Phrase
Gabel	Unmotivated
Visitenkarte	Compound
ein Haar	Phrase
Kreisel entfalten	Phrase
wie Widerspruchsgeist	Phrase
Faden	Unmotivated
war das Fähnchen	Phrase
Zug	Unmotivated
blieb der Wodka	Phrase
Wasserstoff	Compound
das Tor	Phrase
Gipfel	Unmotivated
Hügel	Unmotivated
Spinnrocken	Compound
Falte	Derivative
ein Witzbold	Phrase
sondern eine Wurst	Phrase
eine Stichprobe	Phrase
eiserne Geländer	Phrase
eine Libelle	Phrase
Schnur	Unmotivated
einen winzigen Knäuel	Phrase
das Wägelchen	Phrase
den Deckel	Phrase
Ding	Unmotivated
Kranz	Unmotivated
Zweig	Unmotivated
Häschen	Unmotivated
Vorhang seien	Phrase
Schätzchen	Derivative
kleiner Dieb	Phrase
Muttermal	Compound
Zeichen	Unmotivated
sein Schnäbelchen	Phrase
den Spiegel	Phrase
ein Körnchen	Phrase
ein Körnchen	Phrase
der Keim	Phrase
aus dem Tal eine Aschenstätte	Phrase
Grinsen	Unmotivated
Dienstag	Unmotivated
Grinsen	Unmotivated
So eine Fickfackerei	Phrase
diamantene Königskrone	Phrase
Häubchen	Derivative
Mütze	Derivative
Neger sein	Phrase
Artikel	Unmotivated
Artikelchen werden	Phrase
Mensch	Unmotivated
das Schiffchen	Phrase
Skizze	Unmotivated
eine Kiste	Phrase
Hündin	Unmotivated
das Schnäuzchen	Phrase
Teil	Unmotivated
Betrag	Unmotivated
Teilchen	Unmotivated
Ordnung	Derivative
kleiner Beamter	Phrase
Wimperntusche	Compound
Rettiche	Derivative
den Riemen	Phrase
Kette	Unmotivated
vierschrötiger Mann	Phrase
Zigarre anspitzten	Phrase
die Spitze	Phrase
Schraube	Unmotivated
nach jeder Operation anfallende	Phrase
das Etikett	Phrase
Pinscherweibchen	Compound
eine Tasse	Phrase
Tüchlein	Compound
Heft	Unmotivated
Schneiderin nur halb so alt wie er	Phrase
eine Schnur	Phrase
Judenbengel	Compound
die Leiter	Phrase
Leiter	Unmotivated
Handschellen	Compound
Weibchen	Derivative
Scherz	Unmotivated
Scherz handelt	Phrase
Rinne in Schädeldach graben	Phrase
strebsamer Schüler er	Phrase
das Mieder	Phrase
