lesbienne gecreëerd	Phrase
capsule	Unmotivated
engeltje	Derivative
het engeltje	Phrase
auto	Unmotivated
het vrachtwagentje	Phrase
oma	Unmotivated
pakket	Unmotivated
rugzak	Compound
wekker	Derivative
kistje	Derivative
kistje	Derivative
prieeltje	Derivative
voor joker word	Phrase
notitieboekje te pakken	Phrase
domoor	Unmotivated
zijn hurken zitten	Phrase
brood	Unmotivated
onweer	Derivative
neef	Unmotivated
broertje	Derivative
torretje op en neer	Phrase
maar een wetsteen voor	Phrase
brochure uitgevallen	Phrase
poortje ijzeren hek	Phrase
trommel	Unmotivated
bolhoed	Compound
zweep	Unmotivated
was me een stier	Phrase
zullen we optrekje vinden	Phrase
wezentje had	Phrase
restje	Derivative
buik	Unmotivated
een bordje	Phrase
pad	Unmotivated
hutje	Unmotivated
volkje	Unmotivated
koelte	Derivative
jongetje	Unmotivated
man	Unmotivated
ontvlambaar manneke	Phrase
man	Unmotivated
een groepje	Phrase
broodje	Unmotivated
het grootste deel	Phrase
ochrana	Derivative
omhulsel	Compound
ons arme kind	Phrase
het arme joch	Phrase
tijd	Unmotivated
kleine poosje	Phrase
manco dodelijk	Phrase
straat sigaretje had gerookt	Phrase
zigeunerinnetjes langs bierkan	Phrase
een bonbon	Phrase
zool -	Phrase
stukje	Derivative
stukje bleef uitsteken	Phrase
een cadeautje	Phrase
schijf diameter twaalfenhalve	Phrase
voorstuk ervan ontsnapte rechthoekje	Phrase
taart eten	Phrase
holletje	Derivative
het liefje	Phrase
zwemplas	Compound
zieltje	Derivative
het portier	Phrase
het erf	Phrase
dynamiek	Derivative
het dametje redde mij	Phrase
van de stukjes	Phrase
kind	Unmotivated
theatertje	Unmotivated
theater	Unmotivated
meisje	Unmotivated
hoer	Unmotivated
boerenmeid	Compound
het meisje	Phrase
opa	Unmotivated
opa	Unmotivated
overgrootvader	Compound
werkstuk	Compound
dag	Unmotivated
huisje	Derivative
een pot	Phrase
stuk ik	Phrase
formule voor	Phrase
soort miniatuurpappie	Phrase
stomme opmerking over	Phrase
ellendeling onbenullige parkeerboete vond	Phrase
elastiekjes zitten	Phrase
lapje nat	Phrase
stemmetje	Derivative
de brave borst de	Phrase
aluminium	Unmotivated
drijfveer	Compound
vertakking	Derivative
de moestuin	Phrase
nest gebouwd door	Phrase
uurtje ben je er	Phrase
zijn horloge	Phrase
genot hoor	Phrase
duif	Unmotivated
er een duifje uit zou vliegen	Phrase
meisje	Unmotivated
warmte	Derivative
huisvrouw	Compound
café	Unmotivated
groepje golfde	Phrase
maar viool	Phrase
kam	Unmotivated
tuintje	Derivative
een meeuw	Phrase
een kop	Phrase
kopje	Unmotivated
kopje	Unmotivated
een hoopje	Phrase
klomp	Unmotivated
een handvol	Phrase
peultjes	Derivative
kleine gans frisch	Phrase
ster	Unmotivated
haak	Unmotivated
snoezig dorpskerkje met dodenakker rondom	Phrase
een spijker	Phrase
kruidnagelstelen producten	Phrase
een veulen	Phrase
bijzonderheid	Derivative
toverstok	Compound
een gezinsidylle	Phrase
een appel	Phrase
tong	Unmotivated
eenheid	Derivative
speldenkussen	Compound
tak straalt van	Phrase
rollen over	Phrase
kleine grot	Phrase
meertje	Derivative
teckel	Unmotivated
vonk	Unmotivated
menu	Unmotivated
gang glooiend	Phrase
zaak een hoek	Phrase
top	Unmotivated
tekort	Compound
tree	Unmotivated
tasje	Unmotivated
jasje	Unmotivated
slipje	Derivative
het glas	Phrase
vriend van	Phrase
kacheltje	Unmotivated
zijn kanarie	Phrase
druppeltje	Derivative
pad vandaan een kapelletje	Phrase
zakdoekje	Compound
roodkapje zei sofie	Phrase
mijn kaartje	Phrase
een tandenborstel	Phrase
een braadpannetje	Phrase
plantte een rozenstruik	Phrase
wagentje om een stokje	Phrase
een schrale korenaar	Phrase
schijngevecht	Compound
hoed	Unmotivated
zette kluwen	Phrase
kleine jongen	Phrase
schep roomijs	Phrase
hamer	Unmotivated
sleuteltje	Derivative
was die kant al uit gedrenteld	Phrase
boek	Unmotivated
of ander boekje	Phrase
knoopje van	Phrase
snor	Unmotivated
kleedje	Derivative
een sprinkhaan	Phrase
de kraan	Phrase
de kruiwagen	Phrase
donuts	Unmotivated
nis	Unmotivated
met zijn stomme vingers - nee	Phrase
pot	Unmotivated
heuveltje	Derivative
aap mouw	Phrase
windwijzer wanneer er	Phrase
paar centen hier stuivertje	Phrase
pareltje vallen	Phrase
kubus	Unmotivated
kerkje	Derivative
zwartlinnen mantelpak	Phrase
ketel	Unmotivated
stukje	Derivative
hoekje	Derivative
de bok	Phrase
geitje	Derivative
duvel rond jonge bok	Phrase
poesje	Unmotivated
de kinderwagen	Phrase
taaie die redt	Phrase
mand	Unmotivated
mandje vol	Phrase
groeide een kransje	Phrase
doosje	Unmotivated
sneeuwlandschap het gebergte	Phrase
kleermaker	Compound
waterhoentje hals	Phrase
het puntje van	Phrase
stap	Unmotivated
ring	Unmotivated
blokje	Derivative
konijn	Unmotivated
winkeltje	Derivative
schoonheid	Derivative
nog jonge koe ging	Phrase
koffertje	Derivative
werd ingenomen door de mitraillist	Phrase
kamer naam op	Phrase
malse kip	Phrase
iemand een hoer	Phrase
bloem	Unmotivated
kasplantje	Compound
koffie	Unmotivated
wijsvinger	Compound
silicium	Unmotivated
fauteuil	Unmotivated
vleugeltje	Derivative
kruisje	Derivative
hobby	Unmotivated
vacht	Unmotivated
velletje	Derivative
flesje	Unmotivated
lekkerste eten	Phrase
oorlel te trekken	Phrase
lampje	Unmotivated
staaldraad	Compound
wezel	Unmotivated
bank	Unmotivated
lat	Unmotivated
schedel	Unmotivated
koelkast	Compound
akkevietje neemt	Phrase
boord	Unmotivated
karton	Unmotivated
zomerverblijf	Compound
motor	Unmotivated
lijn	Unmotivated
een briefje	Phrase
jeep schop	Phrase
boot	Unmotivated
bootje versplinteren	Phrase
lantaarns	Derivative
een valstrik	Phrase
zijn gezichtje	Phrase
gezicht dat blanker	Phrase
stokje	Derivative
zwaailicht aan	Phrase
pink	Unmotivated
de veldmaarschalk	Phrase
vlees	Unmotivated
moeder	Unmotivated
moedertje	Derivative
knuffel	Unmotivated
zwaard	Unmotivated
lieveling	Derivative
de baby	Phrase
het knulletje	Phrase
of andere jonge jongen	Phrase
melk opdrinken	Phrase
voortdurend met haar duimen	Phrase
novice heeft	Phrase
hulpmiddel	Compound
stilstaan om motor op gang te laten	Phrase
hersentjes nog van op	Phrase
wolkje	Derivative
wilbur larch	Phrase
eersteklas hinkepoot	Phrase
het mannetje	Phrase
mannetje	Unmotivated
kasteeltje	Derivative
muis	Unmotivated
zeker grootmoedertje	Phrase
vertrek	Derivative
plekje	Derivative
deze bezittingen worden	Phrase
bal	Unmotivated
wastafel vol barsten	Phrase
stadje	Unmotivated
pleintje	Derivative
maan	Unmotivated
het merg	Phrase
ontwaken de doodsklok hoorde luiden	Phrase
roostertje open	Phrase
hoer	Unmotivated
draad	Unmotivated
pootje	Derivative
wipneus	Compound
neusje afgesloten	Phrase
notitieboekje	Compound
nieuws	Unmotivated
iedere klaargemaakte houder hierop	Phrase
verwissel jij die vaatjes boven onze apparatuur opstellen	Phrase
de brancard	Phrase
wolkje	Derivative
heen beklom ten slotte	Phrase
beeld	Unmotivated
staart	Unmotivated
vuurtje	Unmotivated
tinnen soldaat	Phrase
het raampje	Phrase
district van	Phrase
soort altaar opgericht	Phrase
ze een aap was	Phrase
strop	Unmotivated
ezeltje	Derivative
cijfer acht waarempel	Phrase
wezen in godsnaam deze	Phrase
een eilandje	Phrase
schaap	Unmotivated
geen muskaatnoot pepers	Phrase
een knecht	Phrase
tabakszak	Compound
pop	Unmotivated
de marionet	Phrase
vrouwtje	Derivative
het papiertje	Phrase
parkje	Derivative
waarschijnlijk gezelschap al een poosje flink tekeergegaan	Phrase
lok	Unmotivated
afkloof	Compound
nestje bouwen al	Phrase
hondje	Derivative
hondje	Derivative
vernielde kazemat fortificatie	Phrase
piccolootje moest	Phrase
pil	Unmotivated
zo rood als een pioen	Phrase
pleintje	Derivative
dobber	Unmotivated
stripje was	Phrase
plat vlak ontstaat	Phrase
de sluipwegwijzer	Phrase
plakje	Derivative
vlammetje	Derivative
vlammetje	Derivative
dekmantel	Compound
want zo zien kiekje	Phrase
glas	Unmotivated
kamer	Unmotivated
kamertje	Derivative
vak	Unmotivated
vuur gooien	Phrase
plank	Unmotivated
helft	Unmotivated
kussentje	Derivative
het asbakje te voorschijn	Phrase
stuifas	Compound
mug	Unmotivated
zwerver die beroerd	Phrase
poeder	Unmotivated
straaltje	Derivative
wimpel waarmee wordt aangegeven	Phrase
peruaanse luitenant	Phrase
varkentje	Derivative
een regen van	Phrase
kont	Unmotivated
prinsje deed neerbuigend tegen	Phrase
plankje	Derivative
bril	Unmotivated
verhouding	Derivative
ring	Unmotivated
vingertje	Derivative
strook	Unmotivated
zo mager worden een wilgetak	Phrase
lingerie	Derivative
kast	Unmotivated
onweerstaanbare brief	Phrase
boekje	Derivative
vogeljong	Compound
poedeltje op afgesprongen	Phrase
toonbank	Compound
stip	Unmotivated
vlam	Unmotivated
zakje	Derivative
mazelen	Unmotivated
stel	Unmotivated
spannetje	Compound
stoomboot	Compound
veertje	Derivative
fluitje	Derivative
letter	Unmotivated
prei	Unmotivated
liedje	Unmotivated
scheiding	Derivative
uiterst pijnlijke dood sterft	Phrase
helft	Unmotivated
halfuurtje maakte nauwelijks uit	Phrase
voorliggende schouder -	Phrase
bult	Unmotivated
familie	Unmotivated
lieden	Unmotivated
romantiek	Derivative
de prop in mond	Phrase
vlakke plek	Phrase
oriënteren hand	Phrase
de wijzer	Phrase
visje	Unmotivated
visje	Unmotivated
pot	Unmotivated
bedoelde stuk hout om	Phrase
tekstvak	Compound
welke plant	Phrase
het mannetje	Phrase
wijfje	Derivative
ambulance	Unmotivated
snijpunt	Compound
ramde haak	Phrase
het kalf	Phrase
voet hoge sproot	Phrase
zaadje	Unmotivated
zusje	Unmotivated
wijnkelder aan vullen	Phrase
glas	Unmotivated
glas	Unmotivated
glas fonkelde	Phrase
leemte	Derivative
groepje	Derivative
vlekje schitteren	Phrase
kabouter	Unmotivated
vitrine	Derivative
ventje	Unmotivated
paaltje	Derivative
verklarende woordenlijst biedt	Phrase
woord	Unmotivated
woord	Unmotivated
de zon	Phrase
een goede kameraad geweest - een grapjas	Phrase
heer zondert hij deze af	Phrase
beeldje	Derivative
vlaamse gaai	Phrase
scheiden doet hart toch zo lijden	Phrase
sikkel	Unmotivated
verwarde oude heer	Phrase
oude man	Phrase
oude vrouw	Phrase
kippenbout	Compound
stellage neerzetten	Phrase
biedt verschillende mogelijkheden	Phrase
scheerapparaat	Compound
boom	Unmotivated
kerstboom	Compound
korst losgekomen	Phrase
oom	Unmotivated
bron	Unmotivated
studentje verstand kwijt was	Phrase
roodsatijnen lint	Phrase
kleine kudde groepten	Phrase
rendez-vous gevangenisstraf hebben gestaan	Phrase
figuurtje	Unmotivated
serenade	Unmotivated
ook stationskiosk	Phrase
plantentafeltje maken	Phrase
strootje	Derivative
hut	Unmotivated
luifel erboven beschutting bood tegen miezerige regen	Phrase
middelvinger	Compound
zag hoe de wijzer	Phrase
zoveelste stukje	Phrase
slipper	Derivative
tafeltje	Unmotivated
het tafeltje	Phrase
poef slaakte een	Phrase
schriel mannetje geworden	Phrase
oorspronkelijke tombe heel	Phrase
truitje	Derivative
zwijnerij	Derivative
kaars	Unmotivated
kleine waskaars daar hield	Phrase
lichtje	Derivative
kamertje staat voor jullie klaar	Phrase
zoon	Unmotivated
het theezeefje	Phrase
een kerkuil	Phrase
een rennie	Phrase
tabel	Unmotivated
een bordje	Phrase
dansje	Unmotivated
vader	Unmotivated
vader	Unmotivated
een taxi	Phrase
kalfje	Derivative
zesenvijftigjarige taart	Phrase
tante	Unmotivated
kop	Derivative
een kleinigheid waarop	Phrase
t-shirt	Compound
een beetje	Phrase
driehoek	Compound
kistje	Derivative
was een grote plantenbak	Phrase
laatdunkende gezichtje inderdaad	Phrase
schepsel	Derivative
stijf stok	Phrase
het dienblad	Phrase
een beekje	Phrase
lijfje	Derivative
kers	Unmotivated
stumper	Derivative
servet	Unmotivated
koolstof	Compound
heerlijke straat	Phrase
bundeltje	Unmotivated
pak	Unmotivated
staaf	Unmotivated
oorlogen	Unmotivated
vanille	Unmotivated
weduwe van verdere verstoken bleef	Phrase
priestertje	Derivative
overlas riep	Phrase
dorpje was	Phrase
feest	Unmotivated
vork	Unmotivated
visitekaartje	Compound
haartje	Derivative
wolvejong is ooit teruggekomen	Phrase
klotsende water van binnenmeer aan mijn voeten	Phrase
zwakke draad weven	Phrase
was het vlaggetje	Phrase
trein	Unmotivated
wodka	Unmotivated
waterstof	Compound
het hek	Phrase
top	Unmotivated
top	Unmotivated
een tol	Phrase
rimpel	Unmotivated
komiek	Derivative
worstje	Derivative
steekproef	Compound
van hekwerk voorzien hoog opgetast	Phrase
libelle met haar	Phrase
het touwtje	Phrase
rol dollars	Phrase
wagentje	Derivative
ooglid	Compound
ding	Unmotivated
krans	Unmotivated
het takje	Phrase
haas	Unmotivated
façade	Derivative
schatje	Derivative
schuchtere dief	Phrase
teken	Unmotivated
moedervlek	Compound
snavel eendekuiken	Phrase
een spiegeltje	Phrase
een zandkorrel	Phrase
korreltje werd afgenomen	Phrase
kiem van	Phrase
vallei van as geworden	Phrase
lachje	Unmotivated
sindsdien alle dinsdagen	Phrase
grijns	Unmotivated
volkje	Unmotivated
kreeg diadeem spoedmedicijn	Phrase
kapje	Unmotivated
dotje slagroom	Phrase
tienjarig kind	Phrase
artikel	Unmotivated
pracht artikeltje	Phrase
mannetje	Unmotivated
een bootje	Phrase
schets maken	Phrase
een doosje een	Phrase
kut	Unmotivated
zijn neus hoopvol snuivend	Phrase
onderdelen	Compound
bedrag	Compound
stukje	Derivative
orde	Unmotivated
papieren tijger	Phrase
mascara door	Phrase
sprietje van radijs	Phrase
lint	Unmotivated
ketting	Unmotivated
mannetjesputter hier	Phrase
gegeven een stompje	Phrase
het puntje van	Phrase
schroefje los	Phrase
gegrinnikt een stapeltje gegeven	Phrase
etiket	Unmotivated
hondje	Derivative
een kop	Phrase
het sjaaltje los	Phrase
uw schriftje zegt	Phrase
naaister	Derivative
het snoer	Phrase
joodje	Derivative
de ladder	Phrase
schaal gebaseerde tarieven	Phrase
individuele kluisters boeien	Phrase
flier heeft gevraagd	Phrase
grapje	Unmotivated
revgardistisch grapje	Phrase
een gleufje	Phrase
scholiertje	Unmotivated
maïskorrels haar	Phrase
