une lesbienne pas vrai	Phrase
ampoule remplie	Phrase
ange	Unmotivated
un angelot	Phrase
voiture	Derivative
une camionnette	Phrase
grand-mère	Compound
le paquet	Phrase
son sac à dos	Phrase
le réveil	Phrase
une caisse	Phrase
la caisse	Phrase
la tonnelle	Phrase
débile	Unmotivated
bloc papier	Phrase
une petite folle	Phrase
moquette	Derivative
gâteau	Unmotivated
un orage	Phrase
cousin	Unmotivated
petit frère	Phrase
un insecte	Phrase
une pierre noire	Phrase
toujours pages disaient quelque chose	Phrase
porte	Derivative
tambour	Unmotivated
chapeau melon	Phrase
une cravache	Phrase
le taurillon vint	Phrase
immeuble	Unmotivated
air	Unmotivated
retenir mes derniers restes familiaux	Phrase
le ventre	Phrase
une étiquette	Phrase
un sentier	Phrase
une chaumière	Phrase
traînent gens	Phrase
fraîcheur	Derivative
petit garçon	Phrase
type	Unmotivated
petit bonhomme a sauvée	Phrase
type	Unmotivated
couronnée un bouquet	Phrase
un sandwich	Phrase
une petite touffe	Phrase
sécurité dont	Phrase
boîte	Unmotivated
la pauvre	Phrase
la pauvre	Phrase
moment	Unmotivated
un instant	Phrase
mignon	Unmotivated
un petit cigare	Phrase
gitane	Unmotivated
une douceur	Phrase
clou	Unmotivated
un tout petit lambeau	Phrase
nouvelle fit renaître un frêle	Phrase
un cadeau	Phrase
une plaque éinaillée	Phrase
bodruche	Unmotivated
gâteau	Unmotivated
petit repaire déplaît	Phrase
la chérie	Phrase
piscine	Unmotivated
son âme confiante	Phrase
la portière	Phrase
la cour	Phrase
dynamisme	Derivative
dame mûre	Phrase
pièce	Unmotivated
un enfant	Phrase
retour	Unmotivated
cinéma	Unmotivated
petite fille	Phrase
pute	Unmotivated
servante	Derivative
la petite fille	Phrase
le pépé	Phrase
grand-père	Compound
arrière-grand-père	Compound
pour préparer coup	Phrase
lundi fut journée	Phrase
un château	Phrase
une cruche	Phrase
personnage	Derivative
la formule	Phrase
petit papa	Phrase
osée	Unmotivated
gouape	Unmotivated
pastille un fil caoutchouc	Phrase
un tissu exposé	Phrase
voix	Unmotivated
serin bêtasse	Phrase
aluminium	Unmotivated
qualité intrinsèque	Phrase
un rejeton légitime	Phrase
sécheresse qui saccagea carré	Phrase
un nid rapprochant	Phrase
minute	Unmotivated
sa montre	Phrase
commode	Unmotivated
comprit très bien ce petit chéri	Phrase
colombe gris cendré a éventé	Phrase
petite fille	Phrase
chaleur	Derivative
quelle admirable maîtresse de	Phrase
salle où	Phrase
étrange troupe	Phrase
violon minuscule	Phrase
peigne paraîtrait minuscule	Phrase
jardin	Unmotivated
une colombe	Phrase
une tasse	Phrase
tasse	Unmotivated
une tasse	Phrase
pile de	Phrase
une motte	Phrase
une poignée	Phrase
petit pois	Phrase
vois une petite femelle insignifiante	Phrase
une étoile	Phrase
y a un hic	Phrase
cimetière	Derivative
un clou	Phrase
la girofle	Phrase
pouliche	Unmotivated
détail de	Phrase
baguette	Derivative
tableau la idéale atteint la perfection	Phrase
une tomate	Phrase
langue la	Phrase
unité	Unmotivated
pelote recroqueville	Phrase
sentit une fine aiguille lui choir	Phrase
un agnelet	Phrase
grotte	Unmotivated
le lac	Phrase
un lévrier	Phrase
une petite étincelle	Phrase
régime	Unmotivated
sur mètres	Phrase
parfumerie un petit	Phrase
sommet	Unmotivated
le déficit	Phrase
marche tout près	Phrase
sac	Unmotivated
sa veste	Phrase
culotte	Unmotivated
un gobelet	Phrase
tes copains scout	Phrase
poêle	Unmotivated
un canari -il	Phrase
goutte	Unmotivated
chapelle	Derivative
un petit mouchoir	Phrase
petit chaperon rouge	Phrase
vide	Unmotivated
une brosse	Phrase
une petite casserole	Phrase
un buisson	Phrase
un bâton	Phrase
un petit épi	Phrase
une machination	Phrase
petit chapeau	Phrase
le peloton laine	Phrase
un gamin	Phrase
petit gosse	Phrase
le marteau	Phrase
la clef	Phrase
minimum une petite bibliothèque	Phrase
livre	Unmotivated
petit livre	Phrase
bouton	Unmotivated
moustache	Unmotivated
tapis	Unmotivated
une sauterelle	Phrase
le robinet	Phrase
un rond	Phrase
scones beurrés servis par	Phrase
chambrette	Derivative
bout	Unmotivated
petit pot	Phrase
coteau	Derivative
une forme pour une	Phrase
girouette	Unmotivated
une couronne ducale	Phrase
perle lui furent donnés	Phrase
un morceau	Phrase
la petite église	Phrase
tailleur	Derivative
chaudron	Unmotivated
un petit morceau	Phrase
coin	Unmotivated
le siège	Phrase
chèvre	Unmotivated
un cabri	Phrase
mot chat	Phrase
landau	Unmotivated
nature	Unmotivated
un panier	Phrase
un panier	Phrase
bâton dénudé	Phrase
une boîte	Phrase
soldat reconnut un jour dans cette peinture un paysage	Phrase
tailleur	Derivative
le col	Phrase
un morceau pain	Phrase
un pas	Phrase
anneau	Unmotivated
un quignon un carré	Phrase
un lapin	Phrase
la boutique	Phrase
une beauté	Phrase
barbe aussi sera enlevée	Phrase
la mallette	Phrase
mitrailleur vient	Phrase
réduit minuscule	Phrase
poussin	Unmotivated
putain a donc accordé ses	Phrase
fleur	Unmotivated
une petite fleur	Phrase
petit café	Phrase
son index	Phrase
le silicium	Phrase
le fauteuil	Phrase
petite aile	Phrase
la croix	Phrase
petit cheval	Phrase
la fourrure	Phrase
hobbit envelopper un petit	Phrase
le flacon	Phrase
une friandise	Phrase
le lobe	Phrase
la lampe	Phrase
un cable entourant lâchement	Phrase
la belette soient mêmes	Phrase
un banc	Phrase
placé barre	Phrase
crâne	Unmotivated
frigo	Derivative
gigantesque fumisterie	Phrase
col	Unmotivated
le carton	Phrase
pavillon grouillait cobras	Phrase
avion	Unmotivated
ligne	Unmotivated
feuille	Unmotivated
seau	Unmotivated
barque	Unmotivated
petite embarcation	Phrase
furent suspendues à toutes ses branches	Phrase
un piège	Phrase
visage	Derivative
visage trempé	Phrase
tenant sa cuillère	Phrase
gyrophare apportait	Phrase
petit doigt	Phrase
le maréchal	Phrase
viande	Unmotivated
sa mère fût si	Phrase
petite maman	Phrase
en peluche	Phrase
épée	Unmotivated
chérie	Derivative
un bébé	Phrase
le petit jeune	Phrase
petit jeune homme	Phrase
mon petit lait chaud	Phrase
le moulin	Phrase
-ci notre moinillon	Phrase
advienne aide	Phrase
motos	Unmotivated
linotte avec	Phrase
moindre nuage	Phrase
cadavre	Unmotivated
petit infirme	Phrase
petit homme	Phrase
petit homme	Phrase
château	Unmotivated
la souris	Phrase
maman vont bientôt claquer	Phrase
pièce aussi	Phrase
place	Unmotivated
saint-frusquin	Compound
la balle	Phrase
lavabo écaillé absolument minuscule	Phrase
le village	Phrase
la placette	Phrase
la lune	Phrase
la moelle	Phrase
glas	Unmotivated
grille	Unmotivated
la prostituée	Phrase
un fil	Phrase
ta patte	Phrase
petit nez	Phrase
petit nez	Phrase
le carnet	Phrase
une nouveauté	Phrase
générateur aérosol	Phrase
petit matériel	Phrase
une civière	Phrase
un nuage	Phrase
un petit détour	Phrase
image	Unmotivated
la queue	Phrase
un peu feu	Phrase
un petit soldat	Phrase
la vitre	Phrase
le district	Phrase
un petit autel	Phrase
de singe était assise	Phrase
formant nœud coulant	Phrase
petit âne	Phrase
huit allongés	Phrase
personnage	Derivative
un îlot	Phrase
brebis	Unmotivated
une noisette	Phrase
valet de ferme	Phrase
une liasse de	Phrase
une poupée	Phrase
la marionnette	Phrase
petite dame	Phrase
papier	Derivative
square	Unmotivated
partie	Unmotivated
mira restât une frange	Phrase
silex	Unmotivated
réchauffer petit lit	Phrase
chien	Unmotivated
chien	Unmotivated
petit bunker en	Phrase
groom	Unmotivated
pilule	Unmotivated
une pivoine	Phrase
planette	Unmotivated
surveillez vos bouchons	Phrase
vibra une plaque	Phrase
plate-forme	Compound
la carte	Phrase
une tranche	Phrase
ses yeux	Phrase
la flamme	Phrase
son mantelet	Phrase
portrait	Unmotivated
le gobelet	Phrase
chambre	Unmotivated
une pièce minuscule avec entre-deux	Phrase
la case	Phrase
un bout	Phrase
étagère	Derivative
la moitié	Phrase
petit oreiller	Phrase
voir remettre le cendrier	Phrase
fines particules rejetées par	Phrase
boutons hors ceux	Phrase
voyageur égaré présentiez aucun intérêt	Phrase
la poudre	Phrase
filet	Unmotivated
drapeau	Derivative
mon adjudant-chef	Phrase
cochon	Derivative
une pluie	Phrase
point	Unmotivated
un prince	Phrase
siège	Unmotivated
un siège de toilettes	Phrase
mais vous avez de tout petits seins	Phrase
une bague	Phrase
petit doigt	Phrase
filet	Unmotivated
mince une tige saule	Phrase
sous-vêtements	Compound
la commode	Phrase
une lettre	Phrase
opuscule	Unmotivated
un oisillon	Phrase
petit loulou	Phrase
le pupitre	Phrase
couleur	Derivative
ta bouche présent	Phrase
un petit sac contenant	Phrase
la rougeole	Phrase
un couple	Phrase
couples tout	Phrase
vapeur	Derivative
rose	Unmotivated
un sifflet retentit suivi	Phrase
la lettre c	Phrase
un poireau	Phrase
chanson	Unmotivated
sentier	Unmotivated
copain	Unmotivated
moitié	Unmotivated
une demi-heure	Phrase
cintre	Unmotivated
ballot	Derivative
petite famille	Phrase
peuple	Unmotivated
petit roman	Phrase
son bâillon	Phrase
il y avait un espace plan	Phrase
bras	Unmotivated
aiguille	Unmotivated
poisson	Unmotivated
un gardon	Phrase
mare	Unmotivated
avait demanda harry déconcerté	Phrase
cadre	Unmotivated
volera -t-elle la pauvre plante	Phrase
le mâle	Phrase
la femelle	Phrase
une ambulance	Phrase
point croisement	Phrase
hachette	Derivative
un cochon kolkhoze ils	Phrase
une petite pousse	Phrase
une graine de cachée	Phrase
petite sœur	Phrase
oignons	Unmotivated
verre	Unmotivated
verre	Unmotivated
verre	Unmotivated
moindre ouverture	Phrase
un groupe	Phrase
tache	Unmotivated
un elfe	Phrase
une niche	Phrase
petite demoiselle	Phrase
colonne	Derivative
lexique franco-français	Phrase
un mot	Phrase
un mot	Phrase
le soleil	Phrase
si moqueur	Phrase
un bouquet dansait	Phrase
statue	Unmotivated
le geai	Phrase
cœur	Unmotivated
le croissant de la	Phrase
vieux bonhomme	Phrase
le petit vieillard	Phrase
vieille femme	Phrase
une cuisse auriez mangées	Phrase
estrade	Unmotivated
outils	Unmotivated
machine	Unmotivated
sapin	Unmotivated
le sapin	Phrase
une petite croûte	Phrase
oncle	Unmotivated
une fontaine	Phrase
petit étudiant	Phrase
un ruban	Phrase
troupeau	Derivative
rendez-vous	Compound
personnage	Derivative
sérénade leur offrant	Phrase
un kiosque	Phrase
sa place quittai le	Phrase
seul brin	Phrase
petit auvent	Phrase
rafraîchissements un	Phrase
son majeur	Phrase
aiguille déviée	Phrase
un éclats	Phrase
petit soulier	Phrase
la table	Phrase
table	Unmotivated
un tabouret	Phrase
gnome certes oui	Phrase
chapelle précédée	Phrase
sweat-shirt	Compound
une pétaudière	Phrase
bougie	Unmotivated
petite chandelle cire	Phrase
lumière	Derivative
chambrette	Derivative
fils	Unmotivated
un tamis	Phrase
une chouette	Phrase
un cachet	Phrase
tableau	Derivative
une assiette	Phrase
petite ronde	Phrase
papa	Unmotivated
mon père	Phrase
un taxi	Phrase
ton veau tout descendu	Phrase
tante à	Phrase
tante	Unmotivated
titre	Unmotivated
un joli colifichet	Phrase
un tee-shirt	Phrase
un peu	Phrase
sur portait un triangle	Phrase
vieil écrin contenant	Phrase
caisse posée à côté	Phrase
visage remonté à	Phrase
insecte comprenait	Phrase
un houblon	Phrase
le plateau	Phrase
un ruisseau	Phrase
corps	Unmotivated
cerise	Unmotivated
un très pauvre homme sanglota -t-il	Phrase
la serviette	Phrase
carbone	Unmotivated
impasse	Derivative
petite boule aurait dû	Phrase
le paquet	Phrase
rouleau	Derivative
guerres	Unmotivated
vanille	Unmotivated
une veuve	Phrase
petit curé	Phrase
couplet inintelligible	Phrase
village	Unmotivated
soirée	Derivative
fourchette	Derivative
carte	Unmotivated
un cheveu	Phrase
moindre louveteau vint -il	Phrase
vague	Unmotivated
les araignées les subtiles laissent fil trop	Phrase
un fanion	Phrase
train	Unmotivated
la vodka	Phrase
hydrogène	Compound
porte	Derivative
le sommet	Phrase
le sommet	Phrase
un rouet	Phrase
un pli	Phrase
taquin	Unmotivated
saucisse	Unmotivated
échantillon	Derivative
petit péristyle rien	Phrase
la libellule	Phrase
la ficelle	Phrase
une liasse	Phrase
petit chariot	Phrase
le couvercle	Phrase
une chose	Phrase
une couronne	Phrase
une branche	Phrase
pucelle	Derivative
une couverture	Phrase
ma chérie	Phrase
chapardeur	Derivative
type signe	Phrase
grain beauté	Phrase
bec	Unmotivated
un miroir	Phrase
un grain	Phrase
grain	Unmotivated
le germe	Phrase
vallée	Derivative
sourire voulait	Phrase
mardi	Unmotivated
une grimace	Phrase
quel micmac	Phrase
un serre-tête	Phrase
une coiffe	Phrase
toque bien vissée	Phrase
petit nègre	Phrase
article	Unmotivated
faits divers	Phrase
petit bonhomme	Phrase
navette	Derivative
tracer un dessin comme elle apparaîtrait	Phrase
carré	Unmotivated
une chienne	Phrase
museau	Unmotivated
dispositifs auxiliaires	Phrase
le montant	Phrase
parcelle	Derivative
ordre	Unmotivated
petit fonctionnaire	Phrase
quand le mascara coulait avec ses	Phrase
radis	Unmotivated
une laisse	Phrase
la chaîne	Phrase
un courtaud	Phrase
le cigare à	Phrase
pointe	Unmotivated
une vis nickelée	Phrase
une liasse	Phrase
étiquette	Unmotivated
petit bichon frisé	Phrase
une tasse	Phrase
bientôt son mouchoir	Phrase
le carnet	Phrase
la cousette	Phrase
un cordon	Phrase
petit juif	Phrase
une échelle	Phrase
classement	Derivative
les menottes	Phrase
mignonne	Derivative
plaisanterie	Derivative
bonne humeur générale	Phrase
rainure	Derivative
un écolier	Phrase
corsage	Unmotivated
