престарелой выпускнице редклифа	Phrase
адвокат	Derivative
агент	Unmotivated
аристократка торопится	Phrase
помощницей	Derivative
автор	Unmotivated
кельнерша распорядительница	Phrase
к тому же баронесса была недовольна	Phrase
чем баронесса	Phrase
блондинка	Derivative
воительницами оказались как раз молодые	Phrase
пугач	Derivative
брюнетка	Derivative
поэтесса	Derivative
приёмная дочь	Phrase
воспитательница	Derivative
хранительница акбары	Phrase
иностранка	Derivative
таможни	Derivative
одна императрица	Phrase
- дарительницы	Phrase
диагноз	Derivative
докторша	Derivative
товарищ	Derivative
обладательница уже	Phrase
продавщица	Derivative
поклонниц	Derivative
походила на богатую наследницу	Phrase
пчелы	Unmotivated
дворничихи	Derivative
экзистенциалистом	Derivative
же фальшиво-ласковым тоном	Phrase
фермер	Derivative
феминистка мини-юбке	Phrase
разве не красавица	Phrase
философом	Derivative
фотограф сказала - тоже	Phrase
погоня	Unmotivated
сваха	Derivative
голуби	Unmotivated
хозяйка	Derivative
хороша хозяйка	Phrase
профессию музыканта	Phrase
графиня	Derivative
героиня	Derivative
актриса	Derivative
джаннини	Derivative
грешница	Derivative
уголовной полиции	Phrase
преподавательница чуть добродушнее	Phrase
все слышавшая секретарша бледная	Phrase
дипломированным инженером	Phrase
уполномоченный по ведению торговых переговоров	Phrase
ящерица	Derivative
у вас одна квартирантка	Phrase
пленница	Derivative
она компетентная уважаемая деловая женщина	Phrase
предшественник	Derivative
парикмахерша	Derivative
подруга	Derivative
подружка-лесбиянка нашей	Phrase
канцлер германии	Phrase
капитанша	Derivative
ирены вполне успешная пианистка	Phrase
фантазии бесследно пропавшей ювелирши лился необыкновенный	Phrase
уборщица	Derivative
клиентура налаженный домашний быт	Phrase
моей подзащитной	Phrase
хранилище храма	Phrase
библиотекарша	Derivative
словно жрица стояла она посреди	Phrase
сослуживицы	Derivative
комиссар	Derivative
скромно следовала ее горничная далее слуга	Phrase
вино	Unmotivated
красавица	Derivative
кухарка	Derivative
разъяренная сводня указав	Phrase
пригласила к себе заказчица	Phrase
дочка лживой	Phrase
та самая женщина конвертик	Phrase
лютнистка	Derivative
у этой красавицы охотницы	Phrase
врач	Derivative
художница	Derivative
манекенщица а	Phrase
жена	Unmotivated
массажистка	Derivative
эта медичка действительно такого высокого класса	Phrase
рассердилась медведица	Phrase
милостивая пани	Phrase
любовница	Derivative
министр	Unmotivated
молодок никаких	Phrase
пятимесячного возраста	Phrase
работницы	Derivative
натурщица	Derivative
мотоцикл	Compound
мученица	Derivative
потом еще мулатка	Phrase
изобретен мусульманкой	Phrase
мыслитель	Derivative
среди них встречались служащие	Phrase
хозяйка	Derivative
она росла серенькой мещаночкой	Phrase
субретка или	Phrase
наследницы проходят	Phrase
гостья	Derivative
несчастная женщина	Phrase
супруга смотрела	Phrase
журналистка	Derivative
заместитель	Derivative
обладательница ребенка	Phrase
этом настаивала координатор	Phrase
раба твоя	Phrase
пациентка	Derivative
дева	Derivative
императрицы	Derivative
миссис	Unmotivated
стать неплохой подругой	Phrase
пассажирка ударившись	Phrase
покровительница	Derivative
пианистка так вот	Phrase
индивидуальным предпринимателем	Phrase
служанка	Derivative
допрашивала женщина из полиции	Phrase
предстала женщина-полицейский	Phrase
профессиональным политиком	Phrase
риксдага быстро прониклась недоверием к способностям службы	Phrase
юрист хороший знающий американское госрегулирование	Phrase
у беженок	Phrase
премьер-министр	Compound
президент	Derivative
принцесса	Derivative
профессор	Derivative
проститутка	Derivative
работница	Derivative
мой аналитик	Phrase
я же все-таки психолог	Phrase
старшая машинистка	Phrase
изображающая пастушку	Phrase
приемная мать	Phrase
мама-певица разом поняла	Phrase
образованию	Derivative
старая осквернительница рода	Phrase
редактором	Derivative
самки	Unmotivated
председателя	Derivative
рады заместителя премьер-министра	Phrase
хозяйка	Derivative
секретарша	Derivative
сенатор	Derivative
двоюродная сестра	Phrase
последователям до промышленной революции изотопы	Phrase
служанка	Derivative
служительница	Derivative
принадлежавшая к конвенции	Phrase
студенток	Derivative
невеста	Derivative
убежденная – настоящая социалистка	Phrase
соперница	Derivative
заставил многих объявить эту политику провальной	Phrase
судья недрогнувшим	Phrase
соседка	Derivative
моей соложницы	Phrase
сотрудница	Derivative
занимаетесь спортом когда-то входили	Phrase
виртшафтерица	Derivative
организует мэр	Phrase
старуха	Derivative
увлеченная теориями	Phrase
стриптизерша	Derivative
так истово взявшая на себя миротворца	Phrase
студентка	Derivative
термин введенный	Phrase
лидер фронта – имеет неплохие шансы	Phrase
разноцветные детали различной формы	Phrase
приехавшие иммигрантки у которых	Phrase
но при помощи этой посредницы заключенный	Phrase
этой девушки	Phrase
хранительница божественных истин	Phrase
вахты	Unmotivated
свадьба	Derivative
девушка превращалась в святую	Phrase
первый заместитель	Phrase
теща	Unmotivated
техник звукозаписи	Phrase
телефонистка	Derivative
переводчица	Derivative
сверху старушка странница ветер	Phrase
сиделица табачной лавки	Phrase
торговка	Derivative
трубка	Derivative
труба	Unmotivated
карманная кармен	Phrase
карандаш	Derivative
тридцатилетие	Derivative
черненький баловник которому надоели эти церемонии	Phrase
способна одна лишь народная артистка	Phrase
в ученицах жила	Phrase
учительница	Derivative
специальный меленн	Phrase
крестьянка обняла бы	Phrase
вице-президент	Compound
тому же еще патриотка	Phrase
волчица	Derivative
предполагаемая непоколебимая хозяйка	Phrase
росли репа редиска	Phrase
убийцей	Unmotivated
сверстниц	Derivative
посланец	Derivative
являлась экспертом	Phrase
ну пройда	Phrase
поводырь во вседневность	Phrase
лидер	Unmotivated
же не участница соревнования	Phrase
вашей закадычной подругой	Phrase
похожа на беспристрастного исследователя	Phrase
лазутчиков	Derivative
гадалка	Derivative
прокурор из свяжется	Phrase
части	Unmotivated
медсестра	Derivative
заметила рыжуля	Phrase
воровкой	Derivative
певица	Derivative
жестоких надзирательниц присланных	Phrase
колдунья	Derivative
ведьма	Unmotivated
негритянка	Derivative
истинное исчадие ада	Phrase
член	Unmotivated
сорокалетняя молодица	Phrase
участник	Derivative
софи	Unmotivated
кельнерша	Derivative
директриса	Derivative
вагоновожатая погрозила	Phrase
шахматной доски	Phrase
чемпионкой в своем классе	Phrase
сиделка	Derivative
школьница	Derivative
благородного происхождения ефросинии	Phrase
шпионаж	Derivative
стерва притвориться	Phrase
золовка	Derivative
председатель	Derivative
главный редактор	Phrase
еврейка	Derivative
нищенка	Derivative
прокурора анника вместе офисом	Phrase
ученица	Derivative
