vergleichen mit den senilen alten Radcliffe-Alumnen	Phrase
Anwältin	Derivative
Agentin	Derivative
Aristokratin	Derivative
Assistentin	Derivative
Verfasserin	Derivative
Barfrau	Compound
Baronesse	Phrase
Baronin	Derivative
Blondine	Derivative
Kämpfer	Unmarked
Waffe	Unmotivated
rehäugige Brünette	Phrase
Dichterin	Derivative
Pflegetochter	Unmarked
Erzieherin	Derivative
Hüterin	Derivative
Ausländerin	Derivative
Zollhaus	Compound
Kaiserin	Derivative
Spendertier	Unmarked
Diagnose	Derivative
Ärztin	Derivative
Genossin	Derivative
Paßinhaberin	Derivative
Verkäuferin	Derivative
Meine Göttergattin ist seit neuestem	Phrase
Haupterbin die Geschäfte führen	Phrase
Arbeiterinnen	Compound
Hausmeisterin	Derivative
Existentialistin	Derivative
Physikerin eine Gelehrte	Phrase
- Bodenbearbeitung betreibt	Phrase
Feministin	Derivative
sie Nummer	Phrase
Philosophin	Derivative
Fotografin	Derivative
Jagd	Unmotivated
arrangiert gerne Ehen	Phrase
Taube	Unmotivated
Haushälterin	Derivative
Gastgeberin	Derivative
Musikerinnenblick gestülpt	Phrase
Gräfin	Derivative
Heldin	Derivative
Schauspielerin	Derivative
Anwältin	Derivative
Sünderin	Derivative
Lebensmittelkontrolleurin und für	Phrase
Vorturnerin ihre	Phrase
Sprechstundenhilfe	Compound
Ingenieurin	Derivative
Unterhändler bei	Phrase
Eidechse	Phrase
Mieterin	Derivative
Gefangene	Derivative
Geschäftsfrau	Compound
Vorgängerin	Derivative
Friseuse	Derivative
Freundin	Derivative
scharfe Stück hier	Phrase
Kanzlerin	Derivative
Kapitänin	Derivative
Pianistin	Derivative
Schatzkammer	Unmarked
Putzfrau	Compound
Kunden	Derivative
Mandantin	Derivative
Schatzkammer	Unmarked
Bibliothekarin	Derivative
Priesterin	Derivative
Kollegin	Derivative
Kommissarin	Derivative
Zofe	Phrase
Schnaps	Phrase
Schönheit	Unmarked
Köchin	Derivative
Kupplerin	Derivative
Kundin	Derivative
Lügnerin	Derivative
wieder Blitztelegramm gebracht hatte	Phrase
Lautenistin	Derivative
Jägerinnen	Unmotivated
Ärztin	Derivative
Malerin	Derivative
Mannequin	Derivative
Frau	Unmotivated
Therapeutin	Derivative
Medizinstudentin	Derivative
Bärenmutter	Unmarked
gnädige Frau	Phrase
Geliebte	Unmotivated
Ministerin	Derivative
Weibersolo junges Mädchen	Phrase
Kranke	Unmotivated
Helferinnen	Compound
Modell	Unmotivated
Motorrad	Compound
Märtyrerin	Derivative
halbwüchsigen Mulattin hilflosem Aussehen	Phrase
Muslimin	Derivative
Philosophin	Derivative
Arbeitnehmerinnen	Compound
Besitzerin	Derivative
Neubauwohnung lebt	Phrase
Neuankömmlinge noch nicht Bescheid wissen	Phrase
Nachfolgerin von	Phrase
Besucherin	Derivative
Goldkörnchen unglücklichen	Phrase
Jungverheiratete	Compound
Journalistin	Derivative
Untersekretärin des	Phrase
Trägerin	Derivative
Koordinatorin	Derivative
Sklavin	Derivative
Patientin	Derivative
Jungfrau	Compound
Herrscherin	Derivative
Frau	Unmotivated
Partnerin	Derivative
Taxameter weit vor Ende Fahrt	Phrase
Ihrer Namenspatronin	Phrase
Pianistin	Derivative
Unternehmerin	Derivative
Zimmermädchen	Compound
Polizistin verhört wurde	Phrase
Polizistin	Derivative
Politikerin	Derivative
Abgeordnete	Unmotivated
Anwältin	Derivative
selber Flichtling	Phrase
Premierministerin	Derivative
Präsidentin	Derivative
Prinzessin	Derivative
Professor	Unmarked
Prostituierte	Unmotivated
Mitarbeiterin	Derivative
Psychoanalytikerin	Derivative
Psychologin	Derivative
Stenotypistin	Derivative
Hirtin	Derivative
Ziehmutter	Unmarked
Sängerin	Derivative
Beraterin	Derivative
Verräterin	Derivative
Redakteurin	Derivative
Weibchen	Derivative
amtierende Präsidentin	Phrase
Vizepräsidentin der	Phrase
Bäuerin	Derivative
Sekretärin	Derivative
Worten von Senatorin	Phrase
Cousine	Phrase
Nachkommen Evas wahrgenommen werden	Phrase
Bedienerin	Derivative
Dienerin	Derivative
Angehörige	Compound
Zuhörerin	Derivative
Verlobte	Phrase
Sozialistin	Derivative
Rivalin lustig	Phrase
Strafgefangene	Phrase
Richterin	Derivative
Nachbarin	Derivative
undeutlich sichtbaren Gesäß meiner Bettgenossin zuzuwenden	Phrase
Mitarbeiterin	Derivative
Sportlerinnen	Compound
Verwalterin	Derivative
Bürgermeisterin von	Phrase
Alte	Phrase
begeisterte Anhängerin	Phrase
Stripperin	Derivative
als Friedensstifterin fungieren wollte	Phrase
Studentin	Derivative
Oberin	Derivative
Vertreterin	Derivative
Baukasten	Compound
Einwanderer	Unmarked
vor dieser Mittlerin wird	Phrase
Schützin	Derivative
Hüterin	Derivative
Wachstube	Phrase
Hochzeit	Unmarked
Heilige	Phrase
Sekretärin	Derivative
Schwiegermutter	Unmarked
Tontechnikerin	Derivative
Telegrafenfräulein	Derivative
Dolmetscherin	Derivative
Landstreicher	Unmarked
Tabakhändlerin	Derivative
Marktfrau	Compound
Röhre	Unmotivated
Trompete	Phrase
Zwergin	Derivative
Bleistift	Compound
gut erhaltenen Dreißigerin	Phrase
Unglückliche frißt	Phrase
Künstlerin	Derivative
von Lehrmädchen neben	Phrase
Lehrerin	Derivative
Botschafterin	Derivative
Bäuerin	Derivative
Vizepräsidentin	Derivative
Patriotin	Derivative
Wölfin	Derivative
Herrin	Derivative
Stoppelrübe	Compound
Mörderin	Derivative
Altersgenossin	Derivative
Gesandte Frauenrechte Wirklichkeit wird	Phrase
Expertin	Derivative
Betrügerin	Derivative
Platzanweiserin	Derivative
Anführerin	Derivative
Meeresspiegel dahingleitenden Muschel Teilnehmerin des Wettkampfes	Phrase
Vertrauten	Unmotivated
Wissenschaftlerin	Derivative
Spione	Unmotivated
Seherin	Derivative
Vertreterin	Derivative
Waffenkammer	Unmarked
Krankenbetreuerin bei der Bauleitung	Phrase
Rotschopf	Compound
Diebin	Derivative
Sängerin	Derivative
Revierbeamtin	Derivative
Hexe	Derivative
Hexe	Derivative
Negerin	Derivative
Ein unersättliches Teufelchen unsere Valentina	Phrase
Mitglied der	Phrase
Vierzigerin	Derivative
Europäischen Gemeinschaften	Phrase
Leserin	Derivative
Kellnerin	Derivative
Direktorin	Derivative
Chauffeuse	Derivative
Schachbrett	Compound
Eine die schon mal Champion	Phrase
Krankenschwester	Unmarked
Schulmädchen	Compound
Edelfrau	Compound
Spionage	Derivative
Hur	Phrase
Schwägerin	Derivative
Chefin	Derivative
Chefredakteurin	Derivative
Jüdin	Derivative
lang eine Bettlerin	Phrase
Klägerin	Derivative
Schülerin	Derivative
