ancienne élève ecole	Phrase
avocat général	Phrase
un agent	Phrase
aristocrate	Compound
assistante	Derivative
auteure	Derivative
serveuse	Derivative
la baronne	Phrase
la baronne	Phrase
femme blonde	Phrase
soldates	Derivative
grand-mère pétard pudeurs	Phrase
la petite brune	Phrase
poétesse	Derivative
une fille adoptive	Phrase
institutrice qui pour elle-même	Phrase
la gardienne	Phrase
une étrangère	Phrase
la douane	Phrase
impératrice	Derivative
femelle donneuse	Phrase
diagnostic	Unmotivated
la doctoresse	Phrase
madame	Unmotivated
maîtresse	Derivative
la vendeuse	Phrase
admiratrice	Derivative
héritière	Derivative
ouvrière	Derivative
la concierge	Phrase
une philosophe existentialiste	Phrase
en pâtisserie	Phrase
agricultrice	Derivative
féministe	Derivative
belle foâmme	Phrase
philosophe jour	Phrase
photographe	Derivative
poursuite	Derivative
entrée de la maquerelle	Phrase
colombes	Unmotivated
ménagère	Derivative
hôte	Unmotivated
musiciens musiciennes danseuses distrayaient	Phrase
la comtesse	Phrase
héroïne	Derivative
actrice	Derivative
cause	Unmotivated
pécheresse	Derivative
cost-contrôleuse inspectrice	Phrase
monitrice	Derivative
jeune assistante – – course	Phrase
ingénieur	Unmotivated
négociatrice	Derivative
un lézard	Phrase
locataire	Derivative
prisonnière	Derivative
commerçante	Derivative
prédécesseur	Derivative
coiffeurs ici	Phrase
amie	Unmotivated
copine	Unmotivated
chancelière allemande	Phrase
fous	Unmotivated
pianiste appelât	Phrase
trésor	Unmotivated
la femme de ménage	Phrase
clientèle	Derivative
cliente femme	Phrase
trésor	Unmotivated
bibliothécaire	Derivative
prêtresse	Derivative
collègue	Derivative
commissaire	Derivative
femme de chambre	Phrase
alcool	Unmotivated
une beauté	Phrase
la cuisinière	Phrase
maquerelle	Derivative
cliente	Derivative
menteuse comme elle se connaît	Phrase
facteur le	Phrase
la luthiste	Phrase
chasseresse guide	Phrase
la doctoresse	Phrase
peintre	Unmotivated
mannequin	Unmotivated
épouse	Unmotivated
la masseuse	Phrase
ton étudiante en médecine	Phrase
perdu son ourson	Phrase
madame	Unmotivated
maîtresse	Derivative
ministre	Unmotivated
jeune une lourde responsabilité	Phrase
maladie	Derivative
ouvreuse de portes	Phrase
modèle dévêtu	Phrase
moto	Unmotivated
martyre	Derivative
mulâtresse	Derivative
une musulmane	Phrase
la philosophe	Phrase
travailleuse	Derivative
la directrice	Phrase
-ce juste petite bourgeoise	Phrase
naïve	Unmotivated
remplacement de	Phrase
la visiteuse	Phrase
hypersensibles la pauvre	Phrase
jeune mariée	Phrase
journaliste	Derivative
discours	Derivative
lauréate	Derivative
coordinatrice	Derivative
servante	Derivative
patiente	Derivative
vierge	Unmotivated
tsar	Unmotivated
mme	Unmotivated
partenaire	Unmotivated
passagère son	Phrase
dame patronnesse	Phrase
pianiste	Derivative
air	Unmotivated
femme de chambre	Phrase
de la police	Phrase
devant moi une policière	Phrase
femme politique	Phrase
députée	Derivative
avocate	Derivative
rescapée camps	Phrase
première ministre	Phrase
la présidente	Phrase
la princesse	Phrase
le professeur	Phrase
une prostituée	Phrase
assistante	Derivative
psychanalyste bienveillante passa	Phrase
psychologue	Derivative
dactylo	Unmotivated
pastoure	Derivative
vieille mère à chats	Phrase
une cantatrice viennoise	Phrase
conseil financier	Phrase
une traîtresse	Phrase
rédactrice	Derivative
la femelle	Phrase
présidente	Derivative
vice-présidente de	Phrase
la paysanne	Phrase
secrétaire	Derivative
madame sénateur	Phrase
cousine	Unmotivated
successeurs préindustriels ne connaissaient pas	Phrase
la femme de ménage	Phrase
servante	Derivative
femmes	Unmotivated
oehlert	Derivative
fiancée	Derivative
défends socialiste	Phrase
rivale	Unmotivated
personne condamnée	Phrase
la juge	Phrase
voisine	Unmotivated
codétenues apprenaient sur	Phrase
ses compagnes	Phrase
sportifs sportives	Phrase
tant que directrice	Phrase
maire	Unmotivated
la vieille femme	Phrase
roussef comme militante laissent certains	Phrase
laquelle une stripteaseuse entièrement	Phrase
voulait faire office réconciliatrice	Phrase
étudiante	Derivative
la supérieure	Phrase
représentante	Derivative
kits	Unmotivated
immigrées	Derivative
mais avec médiatrice	Phrase
bell qui faisait également partie	Phrase
gardienne de	Phrase
corps de garde	Phrase
mariage	Derivative
la sainte	Phrase
secrétaire liquidatrice	Phrase
belle-mère	Compound
technicienne sans doute	Phrase
veine crytpographique	Phrase
interprète	Unmotivated
clocharde	Derivative
la marchande	Phrase
marchande	Unmotivated
alimentation	Derivative
trompette	Derivative
les naines	Phrase
un crayon	Phrase
femme trente ans	Phrase
friponne	Derivative
une artiste	Phrase
disciple	Unmotivated
la maîtresse	Phrase
ambassadrice	Derivative
une paysanne	Phrase
vice-présidente annette	Phrase
patriote tout ça	Phrase
une louve	Phrase
monarque	Compound
les navets fourragers	Phrase
une tueuse	Phrase
soit ma contemporaine	Phrase
une ambassadrice	Phrase
une experte	Phrase
simulatrice	Derivative
mon ouvreuse	Phrase
chef	Unmotivated
une athlète	Phrase
confidentes	Derivative
femmes scientifiques	Phrase
espions comme	Phrase
une diseuse bonne aventure	Phrase
représentante	Derivative
sont arsenaux	Phrase
infirmière	Derivative
rousse fit glisser	Phrase
une voleuse	Phrase
chanteuse	Derivative
la surveillante fût	Phrase
la sorcière	Phrase
sorcières	Unmotivated
négresse	Derivative
diablesse enragée	Phrase
membre de	Phrase
quarante ans	Phrase
partie intervenante	Phrase
lectrice	Derivative
la servante	Phrase
la directrice	Phrase
la conductrice	Phrase
un échiquier	Phrase
été championne ma classe	Phrase
infirmière	Derivative
écolière	Derivative
bienveillance condescendante	Phrase
espionnage	Derivative
blaireau	Derivative
belle-sœur	Compound
service	Unmotivated
la rédactrice en chef se déplace elle-même	Phrase
juive quel homme	Phrase
une pauvresse	Phrase
la requérante	Phrase
élève	Unmotivated
