Bahre	Unmotivated
Fratze	Unmotivated
Frischling	Derivative
Springbrunnen	Compound
Eigenschaft	Derivative
Untertasse	Compound
Kleinkind	Compound
Büchlein	Derivative
Ablagekorb	Compound
Zauntritt	Unmotivated
Vanille	Unmotivated
Drehleier	Compound
Gipfel	Unmotivated
Städtchen	Derivative
Lotion	Unmotivated
Teilchen	Derivative
kleiner Finger	Phrase
Schachtelhalm	Compound
Wurst	Unmotivated
Kaffeemühle	Compound
Hauskatze	Compound
Saite	Unmotivated
Futterraps	Compound
Mundtuch	Compound
Glas	Unmotivated
Gefäß	Unmotivated
Deckelfolie	Compound
Schlauch	Unmotivated
Helmperlhuhn	Compound
Schnitte	Unmotivated
Karte	Unmotivated
Kinderwagen	Compound
Brustdrüse	Compound
Bettchen	Derivative
Damenunterwäsche	Compound
Zeitungskiosk	Compound
Tante	Unmotivated
verdeckte Operation	Phrase
alter Knacker	Phrase
Zeiger	Derivative
Stelldichein	Compound
Dörfchen	Derivative
Empfangsschein	Compound
Rednerbühne	Compound
Drahtstift	Compound
Kappe	Unmotivated
Pumphose	Unmotivated
Aluminium	Unmotivated
Goldfinger	Compound
Zahnbürste	Compound
Krug	Unmotivated
Bücherbrett	Compound
Teilchen	Derivative
Glossar	Derivative
Wäldchen	Derivative
Tröpfchen	Derivative
Stutenfohlen	Compound
Natrium	Unmotivated
Triebfeder	Compound
Liebesdienerin	Compound
Oberwelle	Compound
Mensch	Unmotivated
Kranium	Unmotivated
Raute	Unmotivated
Boot	Unmotivated
Junge -n	Phrase
Vordach	Compound
Armbanduhr	Compound
Notarztwagen	Compound
Bläschen	Derivative
Handfeger	Compound
Gewittersturm	Compound
Radieschen	Derivative
Gartenanlage	Compound
Kragen	Unmotivated
Ehemännchen	Derivative
Bläschen	Derivative
Windfahne	Compound
Stirnbinde	Compound
Klatschmaul	Compound
Fläschchen	Derivative
Uniformjacke	Compound
Melonenhut	Compound
Mausefalle	Compound
Totenglocke	Compound
Brotkanten	Compound
Lämmchen	Derivative
Mikroorganismen	Compound
Schlinge	Unmotivated
Fregatte	Compound
Vorschule	Compound
Raster	Unmotivated
Dörfchen	Derivative
Karyopse	Unmotivated
Fahne	Unmotivated
Stäubling	Unmotivated
Weihnachtsbaum	Compound
Marionette	Derivative
Päckchen	Derivative
Stündchen	Derivative
Blumenkette	Compound
Klemme	Derivative
Bokkie	Unmotivated
Gartennelke	Compound
Blutzelle	Compound
Scheibe	Unmotivated
nützliches Gerät	Phrase
Schnauzer	Derivative
Pupille	Unmotivated
Spannungsstoß	Compound
Reinlichkeit	Derivative
Grossvater	Compound
Büchse	Unmotivated
Geliebten	Unmotivated
Flügelspitze	Compound
Herbst - s	Phrase
Zuckerkind	Compound
Notarztwagen	Compound
Teil	Unmotivated
RFID-Markierung	Compound
Kette	Unmotivated
Trinkröhrchen	Derivative
Schaltuhr	Compound
Wange	Unmotivated
Entwurf	Unmotivated
Marienblümchen	Derivative
Kreis	Unmotivated
Dachshund	Compound
Ringelblume	Compound
Weg	Unmotivated
Bäuchlein	Derivative
Inselchen	Derivative
Laufmasche	Compound
Birkhuhn	Compound
Membranophon	Unmotivated
Platte	Unmotivated
Maurerkelle	Compound
Sentenz	Unmotivated
Leine	Unmotivated
Glas	Unmotivated
lateinisches Alphabet	Phrase
Hefepilz	Compound
Spiegel	Unmotivated
nützliches Gerät	Phrase
Himmelschlüsselchen	Derivative
Neuigkeit	Derivative
Würfel	Unmotivated
Zauberstab	Compound
Bügel	Unmotivated
Handkoffer	Compound
Kartoffelkäfer	Compound
Handpuppe	Compound
Gipfel	Unmotivated
Dummchen	Derivative
Hügelchen	Derivative
Sehnsucht	Compound
Hilfe	Unmotivated
Silicium	Unmotivated
Knochenmark	Compound
Gottesanbeterin	Compound
Garten…	Derivative
Hustenbonbon	Compound
Kragen	Unmotivated
Hinterbacke	Compound
Priester	Unmotivated
Steckdose	Compound
Sträußchen	Derivative
Harlekin-Marienkäfer	Compound
Abendbrot	Compound
Spross	Unmotivated
Junge	Unmotivated
Röschen	Derivative
Pfanne	Unmotivated
Herz	Unmotivated
Hausaufgabe	Compound
Spross	Unmotivated
Nußsträucher	Compound
Zapfenloch	Compound
Wurst	Unmotivated
Fahrtverlauf	Compound
Stuhl	Unmotivated
Bouteille	Compound
Faktum	Unmotivated
Zollstock	Compound
Äffin	Unmotivated
Langfinger	Compound
Tabak	Unmotivated
Wappenschild	Compound
Steckenpferd	Compound
Kaffeelöffel	Compound
Kükenkopf	Compound
Mittelfinger	Compound
Kanälchen	Derivative
Süßigkeit	Derivative
Bonbon	Unmotivated
Draht	Unmotivated
Getreide	Unmotivated
Weibchen	Derivative
Lämpchen	Derivative
Buntstift	Compound
Repräsentativprobe	Compound
Blaumeise	Compound
Eigenheit	Derivative
Defizit	Derivative
Blauhäher	Compound
Flüsschen	Derivative
junge Frau	Phrase
Erbsen	Unmotivated
Matrixeinheit	Compound
Wattestäbchen	Derivative
Fensteranschlag	Compound
Ofentür die zugemauert wird	Phrase
Granten	Unmotivated
Tülle	Unmotivated
Photo	Unmotivated
Gasse	Unmotivated
Pappe	Unmotivated
Asterisk	Unmotivated
Eiskasten	Compound
Hemd	Unmotivated
Pfad - s	Phrase
Tante	Unmotivated
Kreuzungspunkt m	Phrase
Vater	Unmotivated
Urgroßvater	Compound
Suppengericht	Compound
Kopfzeile	Compound
Eisvogel	Compound
Flaschenzug	Compound
Hobel	Unmotivated
Feuerstein	Compound
Winkel	Unmotivated
Eiskasten	Compound
Päonie	Unmotivated
Stück	Unmotivated
Augenblick	Compound
Elfe	Unmotivated
Zettel	Unmotivated
Kiste	Unmotivated
Staub	Unmotivated
Textilien	Derivative
Mäntelchen	Derivative
Liebling	Derivative
Bank	Unmotivated
Blüte	Unmotivated
Licht	Unmotivated
Steineule	Compound
Zapfen	Unmotivated
Augenblick	Compound
Korb	Unmotivated
Libellen	Derivative
Butterblume	Compound
Besprechung	Derivative
Pfad	Unmotivated
Brücke	Unmotivated
Schnur	Unmotivated
Hagebutte	Compound
Spaßmacher	Compound
Zweig	Unmotivated
Gesangsstück	Compound
Pfeife	Derivative
Vater	Unmotivated
Elfe	Unmotivated
Topfdeckel	Compound
Blumenkette	Compound
Salzfässchen	Derivative
Fluggesellschaft	Compound
Computermaus	Compound
Engelchen	Derivative
Mutter	Unmotivated
Gabel	Unmotivated
Eiskasten	Compound
Frischling	Derivative
Marienblümchen	Derivative
Ostschermaus	Compound
Handfesseln	Compound
Gewicht	Unmotivated
Wurzel	Unmotivated
Häkchen	Derivative
Tasche	Unmotivated
Faser	Unmotivated
Tabelle	Unmotivated
Häschen	Derivative
Schlinge	Unmotivated
Keilhaue	Compound
Fenster	Unmotivated
Kabeldurchführung	Compound
Weinbrand	Compound
Pflock	Unmotivated
T-Shirt	Compound
Kreisel	Derivative
Kanne	Unmotivated
Tablette	Unmotivated
Datenbeschriftung	Compound
jüngere Schwester	Phrase
Straßenprostituierte	Compound
Achtelnote	Compound
Onkel	Unmotivated
nützliches Gerät	Phrase
Schubkarren	Compound
Feldhase	Compound
Betrag	Unmotivated
Dame des Hauses	Phrase
Schwertlilie	Compound
eckige Klammer	Phrase
Schankwirtschaft	Compound
Kleeblatt	Compound
Trinkröhrchen	Derivative
Karte	Unmotivated
Sekundenbruchteil	Compound
uneheliches Kind	Phrase
Kleinkind	Compound
Maulkorb	Compound
Oma	Unmotivated
Frischling	Derivative
Kohlenstoff	Compound
Anrufsammeltaxe	Compound
Streich	Unmotivated
Hackmesser	Compound
Wasserstoff	Compound
