draagstoel	Compound
grijns	Unmotivated
speenvarken	Compound
bron	Unmotivated
bladzijde	Compound
schotel	Unmotivated
wicht	Unmotivated
boekje	Derivative
presenteerblad	Compound
draaihek	Compound
vanille	Unmotivated
draailier	Compound
pinakel	Unmotivated
stadje	Unmotivated
lotion	Unmotivated
item	Unmotivated
de kleine teen	Phrase
paardenstaart	Compound
worst	Unmotivated
molen	Unmotivated
katje	Unmotivated
draad	Unmotivated
raapzaad	Compound
servet	Unmotivated
wijnglas	Compound
bak	Unmotivated
bedekking	Derivative
slang	Unmotivated
poelepetaat	Compound
brood	Unmotivated
visitekaartje	Compound
kinderwagen	Compound
speen	Unmotivated
kinderbed	Compound
linnengoed	Compound
kiosk	Unmotivated
moei	Unmotivated
val	Unmotivated
kerel	Unmotivated
wijzer	Derivative
afspraak	Compound
uithoek	Compound
ticket	Unmotivated
platform	Compound
kruidnagel	Compound
kapotjas	Unmotivated
beenbedekking	Compound
aluminium	Unmotivated
ringvinger	Compound
tandenborstel	Compound
jat	Unmotivated
schap	Unmotivated
streep	Unmotivated
vakwoordenlijst	Compound
hakhout	Compound
druppeltje	Derivative
brug	Unmotivated
natrium	Unmotivated
motief	Derivative
slet	Derivative
rimpeling	Derivative
man	Unmotivated
doodshoofd	Compound
vinkje	Derivative
boot	Unmotivated
teddybeer	Compound
accent circonflexe	Phrase
klok	Unmotivated
ambulancewagen	Compound
vesikel	Unmotivated
stoffer	Derivative
onweersbui	Compound
rammenas	Unmotivated
tuin	Unmotivated
kraag	Unmotivated
man	Unmotivated
blaasje	Unmotivated
windhaan	Compound
hoofdband	Compound
charlatán	Derivative
fiool	Unmotivated
kiel	Unmotivated
garibaldihoed	Derivative
muizeval	Compound
doodsklok	Compound
korst	Unmotivated
lammetje	Derivative
ziektekiem	Compound
muggeziften	Compound
fregat	Unmotivated
kleuterschool	Compound
gekras	Derivative
uithoek	Compound
graanvrucht	Compound
vaandel	Compound
stuifzwam	Compound
kerstboom	Compound
pop	Unmotivated
pakket	Unmotivated
uur	Unmotivated
slingerkrans	Compound
nietje	Unmotivated
schaapachtigen	Derivative
anjer	Unmotivated
bloedcel	Compound
plak	Unmotivated
gadget	Unmotivated
knevel	Unmotivated
pupil	Unmotivated
toppunt	Compound
orde	Unmotivated
grootvader	Compound
pakje	Derivative
zoetelief	Compound
stiefzoon	Compound
herfst	Unmotivated
pink	Unmotivated
ambulancewagen	Compound
schakel	Unmotivated
plaat	Unmotivated
ketting	Unmotivated
rietje	Unmotivated
eierwekker	Compound
koon	Unmotivated
afschaduwing	Derivative
madeliefje	Unmotivated
kwartier	Derivative
dashond	Compound
maansteen	Compound
pad	Unmotivated
bierbuik	Compound
kleine eilanden	Phrase
leer	Unmotivated
korhoen	Unmotivated
trom	Unmotivated
discus	Unmotivated
troffel	Unmotivated
luchtgeest	Compound
drietal	Compound
wijnglas	Compound
handschrift	Compound
gist	Unmotivated
afspiegelen	Compound
gadget	Unmotivated
sleutelbloem	Compound
nieuwigheid	Derivative
dobbelsteen	Compound
toverstaf	Compound
kleerhanger	Compound
portefeuille	Unmotivated
coloradokever	Compound
scholier	Unmotivated
top	Unmotivated
lomperd	Derivative
berg	Unmotivated
lust	Unmotivated
ondersteuning	Compound
système international	Phrase
merg	Unmotivated
bidsprinkhaan	Compound
omgeving	Derivative
tabel	Unmotivated
nek	Unmotivated
bil	Unmotivated
pastoor	Unmotivated
foedraal	Unmotivated
bouquet	Derivative
lieveheerbeestje	Compound
middagmaal	Compound
zaad	Unmotivated
knul	Unmotivated
bloem	Unmotivated
bekken	Unmotivated
kleine hersenen	Phrase
huistaak	Compound
jonge plant	Phrase
hazelnoot	Compound
inkerving	Compound
deegroller	Compound
traject	Unmotivated
maaltand	Compound
fiool	Unmotivated
snoep	Unmotivated
duim als lengtemaat	Phrase
schone vrouw	Phrase
zakkenroller	Compound
tabak	Unmotivated
schild	Unmotivated
idéé-fixe	Compound
lepel	Unmotivated
kuikentje	Derivative
middenvinger	Compound
kanaal	Unmotivated
zoetigheid	Derivative
snoepje	Unmotivated
draad	Unmotivated
korreltje	Unmotivated
wijfje	Derivative
lamp	Unmotivated
crayon	Unmotivated
representatieve steekproef	Phrase
pimpelmees	Compound
eigenheid	Derivative
euvel	Unmotivated
vlaamse gaai	Phrase
beekje	Derivative
meidje	Derivative
erwt	Unmotivated
station	Unmotivated
wattenstaafje	Compound
presenteerblad	Compound
doel	Unmotivated
blauwe bosbes	Phrase
tuit	Unmotivated
diagram	Unmotivated
doorgang	Compound
karton	Unmotivated
sterretje	Derivative
ijskast	Compound
shirt	Unmotivated
pad	Unmotivated
moei	Unmotivated
kruispunt	Compound
ouwe heer	Phrase
overgrootvader	Compound
jat	Unmotivated
hoofd	Unmotivated
ijsvogel	Compound
aandrijfriem	Compound
schaaf	Unmotivated
keisteen	Unmotivated
hoek	Unmotivated
ijskast	Compound
pioen	Unmotivated
opslorpen	Compound
ogenblik	Compound
kabouter	Unmotivated
etiket	Unmotivated
bus	Unmotivated
tablet	Derivative
bonk	Unmotivated
jas	Unmotivated
zoetelief	Compound
bankje	Derivative
bloempje	Unmotivated
bougie	Unmotivated
uil	Unmotivated
haantje	Derivative
poosje	Unmotivated
pakmand	Compound
waterjuffer	Compound
ranonkel	Unmotivated
afspraak	Compound
pad	Unmotivated
vloerkleed	Compound
rijgveter	Compound
roos	Unmotivated
comediant	Derivative
rank	Unmotivated
afstemmen	Compound
fluitje	Derivative
ouwe heer	Phrase
kabouter	Unmotivated
bedekking	Derivative
slingerkrans	Compound
zoutvaatje	Compound
luchtvaartmaatschappij	Compound
muis	Unmotivated
cherubijn	Derivative
moeder	Unmotivated
vork	Unmotivated
diepvries	Compound
speenvarken	Compound
madeliefje	Unmotivated
veldmuis	Compound
handboeien	Compound
halter	Unmotivated
wortel	Unmotivated
angel	Unmotivated
handtasje	Compound
vezel	Unmotivated
bord	Unmotivated
konijntje	Derivative
galgenstrop	Compound
schoffel	Unmotivated
dakraam	Compound
knoop	Unmotivated
wodka	Unmotivated
staak	Unmotivated
jersey	Unmotivated
draaitol	Compound
kruik	Unmotivated
tablet	Derivative
onderscrift	Compound
verpleegster	Derivative
lichtekooi	Compound
achtste noot	Phrase
oom van vaderskant	Phrase
gadget	Unmotivated
grafheuvel	Compound
konijn	Unmotivated
som	Unmotivated
huisvrouw	Compound
zwaardlelie	Compound
blokhaakje	Compound
drenkplaats	Compound
klaver	Unmotivated
rietje	Unmotivated
visitekaartje	Compound
ogenblik	Compound
buitenechtelijk kind	Phrase
boreling	Derivative
muilkorf	Compound
bomma	Unmotivated
speenvarken	Compound
koolstof	Compound
huurrijtuig	Compound
mop	Unmotivated
kling	Unmotivated
waterstof	Compound
