litière	Derivative
sourire affecté	Phrase
porcelet	Derivative
fontaine	Unmotivated
côté	Unmotivated
soucoupe	Derivative
nourisson	Derivative
brochure	Derivative
plateau	Derivative
colonne	Derivative
vanille	Unmotivated
vielle à roue	Phrase
sommet	Unmotivated
bourg	Unmotivated
lotion	Unmotivated
particule	Unmotivated
petit orteil	Phrase
equisetum	Unmotivated
saucisse	Unmotivated
moulin	Unmotivated
minou	Unmotivated
corde	Unmotivated
colza	Unmotivated
serviette	Unmotivated
verre à pied	Phrase
bassin	Unmotivated
couvercle	Unmotivated
tuyau d’arrosage	Phrase
pintade	Compound
pain	Unmotivated
adaptateur	Derivative
wagon	Unmotivated
trayon	Unmotivated
lit d’enfant	Phrase
lingerie	Derivative
stand	Unmotivated
tata	Unmotivated
piege	Unmotivated
bougre	Unmotivated
aiguille	Unmotivated
rendez-vous	Compound
hameau	Unmotivated
références	Unmotivated
podium	Unmotivated
clou de girofle	Phrase
chapeau	Unmotivated
cache sexe	Phrase
aluminium	Unmotivated
doigt annulaire	Phrase
brosse à dents	Phrase
gobelet	Unmotivated
rayonnage	Derivative
segment	Unmotivated
vocabulaire	Derivative
boqueteau	Derivative
goutte	Unmotivated
chevalet	Derivative
sodium	Unmotivated
lieu	Unmotivated
cocotte	Unmotivated
ondelette	Unmotivated
homme	Unmotivated
calotte crânienne	Phrase
croix	Unmotivated
navire	Unmotivated
ours en peluche	Phrase
accent circonflexe	Phrase
montre	Unmotivated
ambulance	Unmotivated
vésicule	Unmotivated
balayette	Derivative
tempête	Unmotivated
radis	Unmotivated
jardin potager	Phrase
col	Unmotivated
mari	Unmotivated
vésicule	Unmotivated
banderole	Unmotivated
serre-tête	Compound
bavard	Unmotivated
fiole	Unmotivated
corsage	Unmotivated
chapeau melon	Phrase
souricière	Derivative
glas	Unmotivated
quignon	Derivative
mouton	Unmotivated
microorganisme	Derivative
nœud	Unmotivated
frégate	Unmotivated
jardin d’enfants	Phrase
réseau	Derivative
hameau	Unmotivated
caryopse	Unmotivated
enseigne	Unmotivated
boviste	Derivative
sapin de noël	Phrase
fantoche	Derivative
matériel d’emballage	Phrase
heure	Unmotivated
guirlande	Unmotivated
broche	Unmotivated
mouton	Unmotivated
œillet de poète	Phrase
globule	Unmotivated
morceau	Derivative
dispositif	Derivative
moustache	Unmotivated
membrane nictitante	Phrase
pic	Unmotivated
relation d’ordre	Phrase
grand-papa	Compound
paquet de la poste	Phrase
amante	Unmotivated
pignon	Derivative
automne	Unmotivated
petit doigt	Phrase
ambulance	Unmotivated
article	Unmotivated
écusson	Derivative
collier	Unmotivated
paille	Unmotivated
compte-minutes	Compound
fesse	Unmotivated
brouillon	Derivative
pâquerette	Derivative
circonscription	Derivative
saucisson à pattes	Phrase
pierre de lune	Phrase
sentier pour piétons	Phrase
bidon	Unmotivated
île	Unmotivated
maille filée	Phrase
tétras lyre	Phrase
ballon	Unmotivated
disque	Unmotivated
aile	Unmotivated
sylphe	Unmotivated
harde	Unmotivated
verre à pied	Phrase
écriture courante	Phrase
levure	Derivative
glace	Unmotivated
dispositif	Derivative
primevère	Unmotivated
nouveauté	Derivative
cube	Unmotivated
baguette	Derivative
portemanteau	Derivative
portefeuille	Unmotivated
chrysomèle	Derivative
poupard	Derivative
cime	Unmotivated
balourd	Unmotivated
monticule	Derivative
désir ardent	Phrase
dispositif	Derivative
silicone	Unmotivated
moelle osseuse	Phrase
mante	Unmotivated
cour	Unmotivated
pastille	Unmotivated
nuque	Unmotivated
fesse	Unmotivated
prêtre	Unmotivated
douille	Unmotivated
fleurette	Derivative
coccinelle asiatique	Phrase
teuf	Unmotivated
bourgeon	Unmotivated
garçon	Unmotivated
fleurette	Derivative
pelvis	Unmotivated
cervelle	Unmotivated
devoirs à la maison	Phrase
bourgeon	Unmotivated
noisetier commun	Phrase
rainure	Derivative
rouleau à pâtisserie	Phrase
parcours	Derivative
pleine lune	Phrase
fiole	Unmotivated
gourmandises	Unmotivated
miette	Unmotivated
beauté	Derivative
chapardeur	Derivative
perlot	Derivative
écusson	Derivative
passe-temps	Compound
cuillère	Derivative
poussin	Unmotivated
médius	Unmotivated
canal	Unmotivated
sucrerie	Derivative
bonbon	Unmotivated
fil de fer	Phrase
grain	Unmotivated
femelle	Unmotivated
loupiote	Derivative
crayon	Unmotivated
mesure	Unmotivated
mésange bleue	Phrase
maniérisme	Derivative
déficit	Unmotivated
geai bleu	Phrase
ruisseau	Unmotivated
fillette	Derivative
petit pois	Phrase
unité	Unmotivated
bâtonnet ouaté	Phrase
strie	Unmotivated
but	Unmotivated
airelle à fruits rouges	Phrase
gicleur	Derivative
représentation	Derivative
allèe	Unmotivated
carton	Unmotivated
astérisque	Derivative
réfrigérateur	Derivative
chemise	Unmotivated
sentier	Unmotivated
tata	Unmotivated
intersection	Derivative
père	Unmotivated
arrière-grand-père	Compound
tasses	Unmotivated
sous-titre	Compound
martin-pêcheur	Compound
poulie mouflée	Phrase
rabot	Unmotivated
silex	Unmotivated
coin	Unmotivated
réfrigérateur	Derivative
pivoine	Unmotivated
petit morceau	Phrase
moment	Unmotivated
sylphe	Unmotivated
étiquette	Unmotivated
coquille	Derivative
pilule	Unmotivated
étoffe	Unmotivated
paletot	Derivative
amante	Unmotivated
banquette	Derivative
fleurette	Derivative
bougie	Unmotivated
chouette	Unmotivated
robinet d’arrêt	Phrase
durée	Unmotivated
seau	Unmotivated
odonatoptères	Derivative
bouton d’or	Phrase
rendez-vous	Compound
raie	Unmotivated
tapis	Unmotivated
lacet de chaussure	Phrase
rose	Unmotivated
clown	Unmotivated
rameau	Derivative
chanson	Unmotivated
sifflet	Derivative
père	Unmotivated
sylphe	Unmotivated
couvercle	Unmotivated
anneau	Unmotivated
salière	Derivative
compagnie aérienne	Phrase
souriceau	Derivative
chérubin	Unmotivated
mère	Unmotivated
fourchette	Derivative
congélateur	Derivative
porcelet	Derivative
pâquerette	Derivative
campagnol	Derivative
menottes	Unmotivated
dumb-bell	Compound
racine	Derivative
caron	Unmotivated
sac	Unmotivated
filament	Unmotivated
tableau	Derivative
roitelet	Derivative
corde	Unmotivated
houe	Unmotivated
lucarne	Unmotivated
nœud	Unmotivated
alcool de bouche	Phrase
pal	Unmotivated
tee-shirt	Compound
toupie	Unmotivated
cruche	Unmotivated
pilule	Unmotivated
légende	Unmotivated
infirmière	Derivative
cocotte	Unmotivated
croche	Unmotivated
tonton	Unmotivated
dispositif	Derivative
galet	Unmotivated
lapin	Unmotivated
somme	Unmotivated
trousse de couture	Phrase
glaïeul	Derivative
parenthèses	Unmotivated
bar	Unmotivated
trèfle	Unmotivated
paille	Unmotivated
carte	Unmotivated
moment	Unmotivated
bâtard	Unmotivated
nourisson	Derivative
bâillon	Derivative
grand-maman	Compound
porcelet	Derivative
carbone	Unmotivated
taxi	Unmotivated
blague	Unmotivated
hache-viande	Compound
hydrogene	Unmotivated
