camilla	Derivative
sonrisa abierta	Phrase
lechón	Derivative
fuente	Unmotivated
faz	Unmotivated
platillo	Derivative
niño de pecho	Phrase
folleto	Derivative
bandeja	Derivative
columna	Unmotivated
vanilla	Derivative
zanfona	Derivative
pináculo	Unmotivated
burgo	Unmotivated
loción	Derivative
corpúsculo	Unmotivated
dedo pequeño	Phrase
cola de caballo	Phrase
fuet	Unmotivated
molinillo	Derivative
gatito	Unmotivated
cuerda	Unmotivated
canola	Unmotivated
servilleta	Derivative
copa	Unmotivated
recipiente	Derivative
párpado	Derivative
manguera	Derivative
gallina de guinea	Phrase
pan	Unmotivated
tarjeta	Derivative
carriola	Unmotivated
teta	Unmotivated
cuna	Unmotivated
ropa íntima	Phrase
quiosco	Unmotivated
tia	Unmotivated
trampa	Unmotivated
socio	Unmotivated
mano	Unmotivated
cita	Unmotivated
aldehuela	Derivative
diploma	Unmotivated
pódium	Unmotivated
clavo de olor	Phrase
capirote	Derivative
calzoncillo	Derivative
alumínio	Derivative
dedo anular	Phrase
corte militar	Phrase
jícara	Derivative
balda	Unmotivated
partícula	Derivative
léxico	Derivative
boscaje	Derivative
glóbulo	Unmotivated
potranca	Derivative
sodio	Unmotivated
motivo	Unmotivated
furcia	Unmotivated
wavelet	Derivative
sujeto	Unmotivated
calavera	Derivative
número	Derivative
embarcación	Derivative
osito de peluche	Phrase
circunflejo	Derivative
cronómetro	Derivative
ambulancia	Derivative
vesícula	Derivative
escobillón	Derivative
bombazo	Derivative
rabanito	Derivative
jardín	Derivative
cuello	Unmotivated
esposo	Derivative
vesícula	Derivative
gatillo	Derivative
diadema	Unmotivated
delatora	Derivative
bote	Unmotivated
blusa	Unmotivated
hongo	Unmotivated
ratonera	Derivative
toque de difuntos	Phrase
mendrugo	Derivative
cordero	Derivative
microorganismos	Derivative
lazo	Unmotivated
fragata	Derivative
jardín de infancia	Phrase
celosía	Derivative
aldea	Unmotivated
cariópside	Derivative
banderín	Derivative
bejín	Unmotivated
árbol de navidad	Phrase
titere	Unmotivated
embalajes	Unmotivated
hora	Unmotivated
guirnalda	Derivative
broche	Unmotivated
papanatas	Unmotivated
clavelito	Derivative
corpúsculo	Unmotivated
pedazo	Derivative
herramienta	Derivative
barba	Unmotivated
retina	Derivative
ápice	Derivative
orden	Unmotivated
padre	Unmotivated
paquete	Derivative
cariña	Unmotivated
hijastro	Compound
otoño	Derivative
dedo pequeño	Phrase
ambulancia	Derivative
artículo	Unmotivated
marbete	Derivative
cadenilla	Derivative
sorvete	Derivative
minuto	Unmotivated
mejilla	Derivative
croquis	Derivative
margarita	Derivative
estado	Derivative
teckel	Unmotivated
caléndula	Unmotivated
vereda	Unmotivated
vientre	Unmotivated
isla	Unmotivated
escalera de mano	Phrase
gallo lira	Phrase
orejas	Compound
disco intervertebral	Phrase
metacarpo	Derivative
pigmeo	Derivative
correa	Unmotivated
copa	Unmotivated
latín	Unmotivated
levadura	Derivative
espejo	Derivative
herramienta	Derivative
prímula	Unmotivated
noticias	Unmotivated
zapata	Unmotivated
varilla	Derivative
colgador	Derivative
billetera	Derivative
leptinotarsa decemlineata	Phrase
mona	Unmotivated
cima	Unmotivated
guanajo	Derivative
monte	Unmotivated
ansia	Unmotivated
widget	Unmotivated
silicio	Derivative
médula ósea	Phrase
santateresa	Derivative
traspatio	Unmotivated
pildora	Unmotivated
cerviz	Unmotivated
nalga	Unmotivated
párroco	Derivative
toma corriente	Phrase
florecilla	Derivative
san antonio	Phrase
carrete	Derivative
retoño	Derivative
niño	Derivative
lozanía	Derivative
pelvis	Unmotivated
tripa	Unmotivated
deberes	Unmotivated
vástago	Derivative
avellanera	Derivative
canal	Derivative
rodillo	Derivative
direccion	Unmotivated
diente molar	Phrase
botella	Derivative
golosina	Derivative
pedazo	Derivative
belleza	Derivative
ratero	Derivative
tabaco	Derivative
tablita	Derivative
pasatiempo	Compound
cucharilla de café	Phrase
cara de pollito	Phrase
dedo corazón	Phrase
canal	Derivative
caramelo	Derivative
caramelo	Derivative
alambre	Unmotivated
grano	Unmotivated
hembra	Unmotivated
bombilla	Derivative
lapiz	Unmotivated
prueba	Unmotivated
herrerillo común	Phrase
amaneramiento	Derivative
carencia	Unmotivated
arrendajo común	Phrase
riachuelo	Derivative
muchacha	Unmotivated
bisalto	Derivative
unidad de disco	Phrase
cotonete	Derivative
canal	Derivative
portería	Derivative
arándano agrio	Phrase
tobera	Derivative
fotografía	Derivative
vía de servicio	Phrase
cartón	Derivative
estrella	Derivative
heladera	Derivative
camiseta	Derivative
vereda	Unmotivated
tia	Unmotivated
intersección	Derivative
papito	Unmotivated
bisabuelo	Derivative
jícara	Derivative
titulillo	Derivative
martín pescador	Phrase
polispasto	Derivative
cepillo	Derivative
sílice	Derivative
ángulo	Unmotivated
heladera	Derivative
peonía	Derivative
ápice	Derivative
instante	Derivative
geniecillo	Derivative
marbete	Derivative
buzon	Unmotivated
harina	Unmotivated
tela	Unmotivated
chaquetilla	Derivative
amor	Unmotivated
escaño	Derivative
lozanía	Derivative
vela	Unmotivated
caburé	Derivative
llave de cierre	Phrase
hora	Unmotivated
cesta	Unmotivated
libélula	Unmotivated
ranúnculo	Derivative
reunión	Derivative
vereda	Unmotivated
moqueta	Derivative
pasador	Derivative
escaramujo	Derivative
burlador	Derivative
rama	Unmotivated
canción	Unmotivated
silbato	Derivative
padre	Unmotivated
geniecillo	Derivative
tápa	Unmotivated
guirnalda	Derivative
salero	Derivative
aerolínea	Derivative
ratón	Derivative
cara de angelito	Phrase
madre	Unmotivated
bifurcación	Derivative
congelador	Derivative
cochinito	Derivative
margarita	Derivative
campañol	Unmotivated
hierros	Compound
mancuerna	Unmotivated
raíz	Unmotivated
hamo	Unmotivated
bolsita	Derivative
filamento	Derivative
pizarrón	Derivative
reyezuelo	Derivative
lazo corredizo	Phrase
azadón	Derivative
ojo de buey	Phrase
ollao reforzado	Phrase
vodka	Derivative
estaca	Unmotivated
jersey	Unmotivated
peonza	Derivative
jarra	Unmotivated
píldora	Derivative
leyenda	Unmotivated
enfermera	Derivative
furcia	Unmotivated
corchea	Unmotivated
tío materno	Phrase
coso	Unmotivated
carretillo	Derivative
damán	Unmotivated
suma	Unmotivated
ama de casa	Phrase
espadilla	Derivative
grapa	Unmotivated
bodegon	Unmotivated
trébol	Derivative
sorvete	Derivative
tarjeta	Derivative
instante	Derivative
hijo natural	Phrase
niño de pecho	Phrase
mordaza	Derivative
nana	Unmotivated
lechón	Derivative
carbono	Derivative
taxímetro	Derivative
broma	Unmotivated
cuchilla	Derivative
hidrógeno	Derivative
