westjet	Compound
gazebo	Unmotivated
main-bras	Compound
package	Derivative
sauge	Unmotivated
sanctuaire	Derivative
clope	Unmotivated
troupe	Unmotivated
cadeau	Derivative
bar-brasserie	Compound
gobelet	Unmotivated
mini-parc	Compound
porte-aiguille	Compound
showstar	Compound
zérène	Derivative
dentifrice	Unmotivated
arbuste	Unmotivated
echinos	Derivative
doigtsle	Unmotivated
grand-magasin	Compound
péristalithe	Derivative
cubicule	Unmotivated
tableau	Derivative
aubepine	Derivative
landais	Derivative
coqueron	Derivative
grillage	Derivative
momument	Unmotivated
personnage	Derivative
lit-parapluie	Compound
logciel	Compound
orthopédie	Unmotivated
cordon	Unmotivated
boulot	Derivative
tangence	Derivative
pyj	Unmotivated
chanson	Unmotivated
moisiversaire	Derivative
ondemètre	Derivative
séance-photo	Compound
interupteurs	Derivative
pitchous	Derivative
roman-photos	Compound
aqua-terrarium	Compound
dico	Unmotivated
statuette	Derivative
sapin	Unmotivated
stand	Unmotivated
auditorium	Unmotivated
t-shirt	Compound
cafteur	Derivative
guerres	Unmotivated
ventilo	Derivative
samu	Unmotivated
bouton	Unmotivated
wikipatch	Compound
étiquet	Unmotivated
