shot-down	Compound
rideing	Unmotivated
bodyafter	Compound
urine	Unmotivated
kcals	Unmotivated
legshe	Unmotivated
drinker	Derivative
snowcat	Compound
balding	Unmotivated
trailhead	Compound
freckles	Unmotivated
fire-truck	Compound
washcloth	Compound
chyrsler	Derivative
cathe	Unmotivated
skin	Unmotivated
seizuring	Derivative
thedog	Compound
scabs	Unmotivated
lollypop	Compound
diprotodon	Derivative
gravel	Unmotivated
ear	Unmotivated
shish	Unmotivated
kokanee	Derivative
heel-side	Compound
humper	Unmotivated
urethras	Compound
parachute	Derivative
twink	Unmotivated
voicebox	Compound
lightline	Compound
thigh	Unmotivated
dollars--	Compound
relaxation	Derivative
girl-ish	Compound
stealership	Derivative
stranger	Derivative
finger	Derivative
prostitute	Unmotivated
plastice	Derivative
combie	Unmotivated
workup	Unmotivated
doughnut	Compound
bed-side	Compound
fours	Unmotivated
poodle	Unmotivated
brainport	Compound
roadway	Compound
hoodie	Derivative
beetch	Unmotivated
land-ownership	Compound
tar	Unmotivated
templar	Derivative
bleeder	Derivative
bits	Unmotivated
chest	Unmotivated
