старушка	Derivative
обвертка	Derivative
простак	Derivative
ураган	Derivative
грудь	Derivative
ребенок	Derivative
клюква	Unmotivated
барабан	Derivative
тропинка	Derivative
холодильник	Derivative
губитель	Derivative
санитарная машина	Phrase
жажда	Derivative
время	Derivative
конфетка	Derivative
материй	Derivative
возлюбленная	Derivative
задний двор	Phrase
лисицы	Unmotivated
дед	Derivative
хутор	Unmotivated
прадед	Derivative
крынка	Derivative
рейтузы	Derivative
кофточка	Derivative
глина	Derivative
алюминий	Derivative
час	Derivative
морщинка	Derivative
девица	Derivative
игольник	Derivative
трактир	Derivative
сопло	Derivative
полёвка	Derivative
садик	Derivative
выступ	Derivative
ягненочек	Derivative
малость	Derivative
бумажник	Derivative
трусы	Unmotivated
шкив	Unmotivated
брошюра	Derivative
уса	Derivative
коврик	Derivative
тачка	Derivative
горбик	Derivative
коляска	Derivative
корзина	Derivative
сорочка	Derivative
чурка	Derivative
корпускула	Derivative
горлышко	Derivative
гирлянда	Derivative
кроль	Unmotivated
бумажник	Derivative
цветок	Derivative
цветок	Derivative
букет	Unmotivated
силикон	Derivative
бутылка	Derivative
яства	Unmotivated
череп	Derivative
холодильник	Derivative
зимородок	Derivative
дорога	Derivative
шлюпка	Derivative
лицо	Derivative
мизинец	Derivative
мизинец	Derivative
плюшевый мишка	Phrase
возлюбленная	Derivative
ребенок	Derivative
мельница	Derivative
пособия	Derivative
синица	Derivative
мороженица	Derivative
мужчина	Derivative
мышка	Derivative
пузырь	Derivative
визитная карточка	Phrase
поблядунья	Derivative
инновация	Derivative
икона	Derivative
местность	Derivative
петля	Derivative
овцы	Unmotivated
кукла	Unmotivated
полка	Derivative
ручеек	Derivative
поросёнок	Derivative
домашняя работа	Phrase
первоцвет	Derivative
дамское бельё	Phrase
волдырь	Derivative
фурункул	Derivative
корь	Derivative
колбаса	Derivative
песня	Derivative
вешалка	Derivative
проказник	Derivative
самка	Derivative
санитарная машина	Phrase
дровокол	Derivative
поросёнок	Derivative
пестование	Derivative
афоризм	Unmotivated
отличительная особенность	Phrase
косяк	Derivative
натрий	Unmotivated
кафедра	Unmotivated
инструмент	Derivative
дядька	Derivative
средний палец	Phrase
свеча зажигания	Phrase
солонка	Derivative
табак	Derivative
батюшка	Derivative
патер	Derivative
таксомотор	Derivative
тетка	Derivative
тетка	Derivative
тетерев	Derivative
шнурование	Derivative
тенниска	Derivative
сертификация	Derivative
поднос	Derivative
углекислота	Derivative
поросёнок	Derivative
хутор	Unmotivated
визитная карточка	Phrase
юла	Derivative
лосьон	Unmotivated
водород	Derivative
лира	Unmotivated
миг	Derivative
комик	Derivative
стрекозы и красотки	Phrase
веко	Derivative
инструмент	Derivative
ябедник	Derivative
гирлянда	Derivative
скобка	Derivative
микроб	Derivative
проказник	Derivative
часть	Derivative
эскиз	Derivative
инструмент	Derivative
пылинка	Derivative
привязь	Derivative
детский сад	Phrase
лопаточка	Derivative
лицо	Derivative
