Oma	Unmotivated
Packstück	Compound
Hohlkopf	Compound
Unwetter	Derivative
Brust	Unmotivated
Kind	Unmotivated
Großfrüchtige Moosbeere	Phrase
kleine Trommel	Phrase
Pfad	Unmotivated
Eiskasten	Compound
Stallbursche	Compound
Krankenwagen	Compound
Gelüst	Unmotivated
Weilchen	Unmotivated
Naschereien	Compound
Leinen	Unmotivated
Herzchen	Derivative
Garten	Unmotivated
Straßenhure	Compound
Großvater	Compound
Querstraßen	Compound
Urgroßvater	Compound
Kanne	Unmotivated
Schlauch	Unmotivated
Uniformjacke	Compound
Kleiboden	Compound
Aluminium	Unmotivated
Stunde	Unmotivated
Hahnenfußgewächs	Compound
junge Frau	Phrase
Familienfürsorger	Compound
Kneipe	Unmotivated
Endstück	Compound
Schermaus	Compound
Garten	Unmotivated
ausgebeulte Stelle	Phrase
Bokkie	Unmotivated
Fehlmenge	Compound
Sack	Unmotivated
Schubkästen	Compound
Seilrolle	Compound
Prospekt	Unmotivated
Schnurrbart	Compound
kleiner dicker Teppich	Phrase
Scheibtruhe	Compound
Eishügel	Compound
Wagen	Unmotivated
Abfalleimer	Compound
T-Shirt	Compound
Päckchen	Derivative
Blutkörperchen	Compound
Kragen	Unmotivated
Blumenkette	Compound
Feldhase	Compound
Büchermappe	Compound
Blümchen	Derivative
Blüte	Unmotivated
Blumensträußchen	Compound
SI-Einheit	Compound
Fläschchen	Derivative
Leckerei	Derivative
Schädel	Unmotivated
Eiskasten	Compound
Eisvogel	Compound
Richtung	Derivative
Boot	Unmotivated
Wange	Unmotivated
kleiner Finger	Phrase
kleiner Finger	Phrase
Bären	Unmotivated
Herzchen	Derivative
Kind	Unmotivated
Kaffeemühle	Compound
Beistand	Unmotivated
Blaumeise	Compound
Eiskasten	Compound
Herr	Unmotivated
Maus	Unmotivated
Bläschen	Unmotivated
Visitenkarte	Compound
Freudenmädchen	Compound
Erfindung	Derivative
Bild	Unmotivated
Region	Unmotivated
Schleife	Unmotivated
Bokkie	Unmotivated
Handpuppe	Compound
Gesims	Unmotivated
Flüsschen	Unmotivated
Sparbüchse	Compound
Hausaufgabe	Compound
Himmelschlüsselchen	Compound
Damenunterwäsche	Compound
kleine Blase	Phrase
Furunkel	Compound
Masern	Unmotivated
Wiener Würstchen	Phrase
Gesangsstück	Compound
Bügel	Unmotivated
Elfe	Unmotivated
Weibchen	Derivative
Krankenwagen	Compound
Hackmesser	Compound
Frischling	Derivative
Krankenpflegerin	Compound
Elfe	Unmotivated
Eigenheit	Derivative
Zauntritt	Unmotivated
Natrium	Unmotivated
Rednerbühne	Compound
Mittel	Unmotivated
Onkel	Unmotivated
Mittelfinger	Compound
Kerze	Unmotivated
Salzfässchen	Compound
Tabak	Unmotivated
Vater	Unmotivated
Vater	Unmotivated
Anrufsammeltaxe	Compound
Muhme	Unmotivated
Muhme	Unmotivated
Birkhuhn	Compound
Schuhbänder	Compound
T-Shirt	Compound
Empfangsbestätigung	Compound
Ablagekasten	Compound
Kohlenstoff	Compound
Frischling	Derivative
Querstraßen	Compound
Visitenkarte	Compound
Spielkreisel	Compound
Lotion	Unmotivated
Wasserstoff	Compound
Drehleier	Compound
Wimpernschlag	Compound
Komödiantin	Derivative
Libelle	Unmotivated
Deckelfolie	Compound
Mittel	Unmotivated
Zwischenträger	Compound
Blumenkette	Compound
Klammer	Derivative
Mikroorganismen	Compound
Elfe	Unmotivated
Teil	Unmotivated
Skizze	Unmotivated
Mittel	Unmotivated
Partikel	Unmotivated
Kette	Unmotivated
Vorschule	Compound
Applikationsgerät	Compound
Seele	Unmotivated
