oma	Unmotivated
omhulsel	Compound
domoor	Unmotivated
donderslag	Compound
borst	Unmotivated
kind	Unmotivated
amerikaanse veenbes	Phrase
snarentrom	Compound
paadje	Unmotivated
koelkast	Compound
kerel	Unmotivated
ambulancewagen	Compound
zin	Unmotivated
momentje	Unmotivated
snoepgoed	Compound
stukje	Derivative
liefje	Unmotivated
achtertuin	Compound
straatmeid	Compound
bompa	Unmotivated
dorp	Unmotivated
overgrootvader	Compound
kruik	Unmotivated
slang	Unmotivated
kiel	Unmotivated
klei	Unmotivated
aluminium	Unmotivated
uur	Unmotivated
boterbloem	Compound
meiske	Unmotivated
huisvrouw	Compound
kroeg	Unmotivated
overloopventiel	Compound
veldmuis	Compound
tuin	Unmotivated
bult	Unmotivated
lamsvlees	Compound
kastekort	Compound
zak	Unmotivated
lange broek	Phrase
aandrijfriem	Compound
brochure	Derivative
baard	Unmotivated
tapijt	Unmotivated
kruiwagen	Compound
berg	Unmotivated
kinderwagen	Compound
sluitmand	Compound
kaft	Unmotivated
pakje	Derivative
pilletje	Unmotivated
cervix	Unmotivated
krans	Unmotivated
konijn	Unmotivated
brieventas	Compound
blom	Derivative
blom	Derivative
boeket	Unmotivated
silicium	Unmotivated
flesje	Unmotivated
delicatesse	Derivative
schedel	Unmotivated
koelkast	Compound
ijsvogel	Compound
route	Unmotivated
schuit	Unmotivated
koon	Unmotivated
pink	Unmotivated
pink	Unmotivated
beren	Unmotivated
liefje	Unmotivated
kind	Unmotivated
molen	Unmotivated
behulp	Derivative
pimpelmees	Compound
diepvrieskast	Compound
kerel	Unmotivated
huismuis	Compound
vesikel	Unmotivated
visitekaartje	Compound
vrouw van lichte zeden	Phrase
uitvinding	Compound
beeld	Unmotivated
regio	Unmotivated
loop	Unmotivated
schaap	Unmotivated
tonnetje	Derivative
schap	Unmotivated
beek	Unmotivated
spaarvarken	Compound
huistaak	Compound
primula	Unmotivated
linnengoed	Compound
vesikel	Unmotivated
pukkel	Unmotivated
mazelen	Unmotivated
beuling	Derivative
lied	Unmotivated
klerenhanger	Compound
kwelgeest	Compound
wijfje	Derivative
ambulancewagen	Compound
lemmet	Unmotivated
speenvarken	Compound
verpleegster	Derivative
kabouter	Unmotivated
eigenaardigheid	Compound
draaihek	Compound
natrium	Unmotivated
leerstoel	Compound
gereedschap	Derivative
oom	Unmotivated
middenvinger	Compound
ontstekingsbougie	Compound
zoutvaatje	Compound
tabak	Unmotivated
papa	Unmotivated
papa	Unmotivated
taxi	Unmotivated
moeij	Derivative
moeij	Derivative
korhoen	Unmotivated
rijgsnoer	Compound
jersey	Unmotivated
bevoegdheidsverklaring	Compound
dienblad	Compound
koolstof	Compound
speenvarken	Compound
dorp	Unmotivated
visitekaartje	Compound
a-al-tolletje	Compound
lotion	Unmotivated
waterstof	Compound
draaiorgel	Compound
ogenblik	Compound
humorist	Derivative
juffertje	Derivative
ooglid	Compound
gereedschap	Derivative
kletskous	Compound
krans	Unmotivated
haakjes	Derivative
ziektekiem	Compound
kwelgeest	Compound
deel	Unmotivated
schets	Unmotivated
gereedschap	Derivative
deeltje	Derivative
drietal	Compound
kleuterschool	Compound
wattenstaafje	Compound
ziel	Unmotivated
