grand‐maman	Compound
colispetit	Unmotivated
imbécile	Derivative
tempête	Unmotivated
glande mammaire	Phrase
jolie fille	Phrase
myrtille	Derivative
bongo	Unmotivated
sentier pedestre	Phrase
frigo	Derivative
gars	Unmotivated
ambulance	Unmotivated
désir ardent	Phrase
durée	Derivative
sucrerie	Derivative
toile	Unmotivated
cœur	Unmotivated
arrière-cour	Derivative
fille de joie	Phrase
grand-papa	Derivative
hameau	Derivative
arrière-grand-père maternel coté grand-père	Phrase
cruche	Unmotivated
tuyau	Unmotivated
corsage	Derivative
argile	Unmotivated
aluminium	Unmotivated
heure	Unmotivated
grenouillette	Derivative
jeune fille	Phrase
ménagère	Derivative
bar	Unmotivated
gicleur	Derivative
campagnol	Derivative
jardin	Unmotivated
bouge	Unmotivated
mouton	Derivative
déficit budgétaire	Phrase
sac à main	Phrase
pantalon	Derivative
bigue	Unmotivated
pamphlet	Derivative
moustache	Unmotivated
pose de moquette	Phrase
brouette	Derivative
monticule	Derivative
wagon	Derivative
panier à couvercle	Phrase
chemise	Unmotivated
paquet de la poste	Phrase
corpuscule	Unmotivated
nuque	Unmotivated
guirlande	Unmotivated
lièvre	Unmotivated
attaché-case	Compound
floraison	Derivative
floraison	Derivative
bouquet de fleurs	Phrase
silicone	Unmotivated
bouteille	Derivative
gourmandises	Unmotivated
calotte crânienne	Phrase
frigo	Derivative
alcyon	Derivative
route	Unmotivated
bateau	Derivative
fesse	Unmotivated
petit doigt	Phrase
petit doigt	Phrase
ours en peluche	Phrase
cœur	Unmotivated
jolie fille	Phrase
moulin	Unmotivated
soutien	Unmotivated
mésange bleue	Phrase
congélateur	Derivative
gars	Unmotivated
raton	Derivative
vésicule	Unmotivated
adaptateur	Derivative
fille de joie	Phrase
invention	Derivative
effigie	Unmotivated
quartier	Derivative
nœud coulant	Phrase
mouton	Derivative
poupée	Derivative
étagère	Derivative
ruisselet	Derivative
cochon tirelire	Phrase
devoirs à la maison	Phrase
primevère	Unmotivated
sous-vêtement	Derivative
cloque	Unmotivated
pustule	Unmotivated
éruption morbilleuse	Phrase
saucisse	Unmotivated
chanson	Derivative
cintre	Unmotivated
esprit follet	Phrase
metz	Unmotivated
ambulance	Unmotivated
merlin	Unmotivated
porcelet	Derivative
aide-soignante	Derivative
esprit follet	Phrase
maniérisme	Derivative
chambranle	Unmotivated
sodium	Unmotivated
podium	Unmotivated
dispositif	Derivative
oncle	Unmotivated
médium	Unmotivated
bougie électrique	Phrase
salière	Derivative
perlot	Derivative
papa	Unmotivated
papa	Unmotivated
taxi-bus	Compound
tata	Unmotivated
tata	Unmotivated
tétras lyre	Phrase
lacet de chaussure	Phrase
t shirt	Phrase
titre	Unmotivated
plate	Unmotivated
carbone	Unmotivated
porcelet	Derivative
hameau	Derivative
adaptateur	Derivative
toupie	Unmotivated
huile solaire	Phrase
hydrogène	Compound
vielle à roue	Phrase
moment	Unmotivated
acteur comique	Phrase
odonatoptères	Derivative
paupière	Derivative
truc	Derivative
babillard	Derivative
guirlande	Unmotivated
parenthèse	Derivative
microorganisme	Derivative
esprit follet	Phrase
part	Unmotivated
ébauche	Unmotivated
dispositif	Derivative
atome	Unmotivated
harde	Unmotivated
garderie	Derivative
bâtonnet ouaté	Phrase
individu	Unmotivated
