maletín	Derivative
maletín	Derivative
arzobispos	Unmotivated
evento	Unmotivated
bisabuelo	Derivative
bisabuelo	Derivative
helicóptero	Derivative
cama de flores	Phrase
quemador de piloto	Phrase
varita mágica	Phrase
varita mágica	Phrase
pensión	Derivative
bigote	Derivative
compresor	Derivative
cesta	Unmotivated
ceja	Unmotivated
ermitaño	Derivative
princesa	Unmotivated
porcentaje	Derivative
lencería	Derivative
suicidio	Unmotivated
silueta	Derivative
subgrupo	Derivative
resultados	Unmotivated
diccionario	Derivative
especialidad	Derivative
explicación	Derivative
transformadores	Derivative
cuerpo	Unmotivated
carbón	Derivative
carbón	Derivative
ardilla	Derivative
ardilla	Derivative
ardilla	Derivative
hidrógeno	Derivative
salud	Unmotivated
revista	Derivative
chocolate	Unmotivated
sala de lectura	Phrase
guardarropa	Unmotivated
tortuga	Unmotivated
