Motorradfahrer	Unmarked
Architekt	Unmotivated
Adapter	Unmarked
Aggressor	Unmarked
Akkordeonist	Unmarked
Aktivist	Unmarked
Amateur	Derivative
Analytiker	Unmarked
Anästhesist	Unmarked
Animator	Unmarked
Archäologe	Unmarked
Archivar	Derivative
Astronaut	Derivative
Autor	Unmarked
Banker	Unmarked
Bibliograph	Unmotivated
Biologe	Unmarked
Mikrobiologe	Unmarked
Biber	Unmarked
Biber	Unmarked
Skater	Unmarked
Läufer	Unmarked
Cellist	Unmarked
Zertifizierer	Unmarked
Chartist	Unmarked
Alchimist	Unmarked
Chirurgen	Derivative
Züchter	Unmarked
Konditor	Unmarked
Cyclonudist	Unmarked
Kaiserin	Derivative
Spender	Unmarked
Dekorateur	Derivative
Demograph	Unmotivated
Demonstrator	Unmarked
Dermatologe	Unmarked
Diktator	Unmarked
Verteiler	Unmarked
Schuldner	Unmarked
Auktionator	Unmarked
Genosse	Unmotivated
Editor	Unmarked
Elektriker	Unmarked
Elektroingenieur	Compound
Endokrinologe	Unmarked
Epidemiologe	Unmarked
Essayist	Unmarked
Evangelist	Unmarked
Philosoph	Compound
Fotograf	Unmotivated
Physiognom	Unmotivated
Physiologe	Unmarked
Physiotherapeut	Compound
Physiotherapeut	Compound
Gastroenterologe	Unmarked
Geograph	Unmotivated
Geologe	Unmarked
Gerontologe	Unmarked
Gladiator	Unmarked
Gouverneur	Derivative
Gynäkologe	Unmarked
Feuerwehrmann	Unmarked
Hämatologe	Unmarked
Hermaphrodit	Unmarked
Matchmaker	Unmarked
Taube	Unmotivated
Taube	Unmotivated
Taube	Unmotivated
Horizont	Unmotivated
Bergsteiger	Unmarked
Violinist	Unmarked
Violinist	Unmarked
Musiker	Unmarked
Gräfin	Derivative
Darstellerin	Derivative
Humorist	Unmarked
Hydrobiologe	Unmarked
Illustrator	Unmarked
Illusionist	Unmarked
Immunologe	Unmarked
Inspektor	Unmarked
Investor	Unmarked
Entdecker	Unmarked
Nenner	Unmarked
Vorgänger	Unmarked
Kadettenanstalt	Compound
Kardiologe	Unmarked
Kartograph	Unmotivated
Klarinettist	Unmarked
Pianist	Unmarked
Bioklimatologe	Unmarked
Gründer	Unmarked
Priesterin	Derivative
Kommentator	Unmarked
Konsul	Unmotivated
Pionier	Unmarked
Kubist	Unmarked
Prediger	Unmarked
Encoder	Unmarked
Lexikograph	Unmotivated
Linguist	Unmarked
Lobbyist	Unmarked
Logograph	Unmotivated
Skifahrer	Unmarked
Bergsteiger	Unmarked
Madrigalist	Unmarked
Magnat	Unmotivated
Maler	Unmarked
Mandolinistin	Derivative
Minister	Unmarked
Minister	Unmarked
Schmetterling	Compound
Märtyrer	Unmarked
Musikwissenschaftler	Unmarked
Arbeitgeber	Unmarked
Eigentümer	Unmarked
Nachfolger	Unmarked
Novotomist	Unmarked
Journalist	Unmarked
Entführer	Unmarked
Soldat	Derivative
Soldat	Derivative
Oligopolistin	Derivative
Operator	Unmarked
Koordinator	Unmarked
Ornithologe	Unmarked
Paläograph	Unmotivated
Papier	Unmarked
Parapsychologe	Unmarked
Parasit	Unmarked
Parodist	Unmarked
Pathologe	Unmarked
Pirat	Unmotivated
Schwimmer	Unmarked
Planer	Unmarked
Porträtist	Unmarked
Pilger	Unmarked
Präfekt	Derivative
Premierminister	Unmarked
Präsident	Unmarked
Präsident	Unmarked
Prinzessin	Derivative
Programmierer	Unmarked
Propagandist	Unmarked
Psychiatrie	Unmotivated
Psychoanalytiker	Unmarked
Psychologe	Unmarked
Schäferin	Derivative
Rapper	Unmarked
Regent	Unmarked
Rektor	Unmarked
Hersteller	Unmarked
Saxophonist	Unmarked
Komponist	Unmarked
Hörer	Unmarked
Snob	Unmotivated
Bildhauerin	Derivative
Soziologe	Unmarked
Koeffizient	Unmarked
Spezialist	Unmarked
Mitbürger	Unmarked
Sponsoring	Derivative
Administrator	Unmarked
Artillerie	Unmotivated
Geier	Unmarked
Hochzeit	Unmarked
Befreier	Unmarked
Zeuge	Unmotivated
Sekretär	Unmotivated
Technologe	Unmarked
Tennisspieler	Unmarked
Theologe	Unmarked
Therapeut	Unmotivated
Terminologe	Unmarked
Terrorist	Unmarked
Tischler	Unmarked
Taucher	Unmarked
Traktor	Unmarked
Bleistift	Compound
Schöpfer	Unmarked
Neurologe	Unmarked
Utopist	Unmarked
Kamel	Unmotivated
Kommandant	Unmarked
Virologe	Unmarked
Vitalist	Unmarked
Voyeur	Derivative
Erfinder	Unmarked
Personalvermittler	Unmarked
Landvermesser	Unmarked
Zenist	Unmarked
Beichtvater	Unmarked
Sänger	Unmarked
Gesetzgeber	Unmarked
Beobachter	Unmarked
Hexe	Derivative
Hexe	Derivative
Mitglied	Compound
Leser	Unmarked
Mikrocomputer	Unmarked
Direktor	Unmarked
Direktor	Unmarked
Treiber	Unmarked
Schimpanse	Unmotivated
Spionage	Derivative
Benutzer	Unmarked
