cream	Unmotivated
tack	Unmotivated
window	Unmotivated
cash	Unmotivated
curtilage	Derivative
pilferer	Derivative
fool	Unmotivated
amount	Derivative
ball	Unmotivated
herb	Unmotivated
hermit	Unmotivated
circumflex	Compound
neck	Unmotivated
pot	Unmotivated
soul	Unmotivated
sheaf	Phrase
rack	Unmotivated
toilet seat	Phrase
grinding machine	Phrase
stove	Unmotivated
pussy	Derivative
vesicle	Derivative
face	Unmotivated
sense	Unmotivated
chopper	Derivative
little boy	Phrase
cow	Unmotivated
reading room	Phrase
bits	Unmotivated
soldier	Unmotivated
tag	Unmotivated
carbon	Unmotivated
little boy	Phrase
roadway	Derivative
event	Unmotivated
button	Unmotivated
truck	Unmotivated
combie	Derivative
common daisy	Phrase
explanation	Derivative
cuff	Unmotivated
diagram	Unmotivated
of leeks	Phrase
snowcat	Compound
blanket	Unmotivated
stream of	Phrase
malignant little friend	Phrase
square	Unmotivated
suicide	Unmotivated
blouse	Unmotivated
hairband	Compound
channel	Unmotivated
table	Derivative
diets	Unmotivated
mother	Unmotivated
bird	Unmotivated
cousin	Unmotivated
potato beetle	Phrase
hand broom	Phrase
ultraviolets	Derivative
housewife	Compound
table	Derivative
trackway	Derivative
cup	Unmotivated
weasel	Phrase
muffin	Unmotivated
handful of	Phrase
strip of	Phrase
hook	Unmotivated
male	Derivative
son	Unmotivated
moonstone	Compound
granny	Derivative
bottle	Derivative
time	Unmotivated
catheter	Derivative
conditioning	Unmotivated
performance	Derivative
day nurseries	Phrase
lingerie	Derivative
surge	Unmotivated
glossary	Derivative
light bulb	Phrase
poop	Unmotivated
his pocket bead	Phrase
cat	Unmotivated
quaver	Unmotivated
fence	Unmotivated
clown	Unmotivated
milk	Unmotivated
screw	Unmotivated
chart	Unmotivated
spick	Unmotivated
forcing	Unmotivated
tatee	Derivative
feather	Unmotivated
thing	Unmotivated
umbrellas	Compound
weather	Unmotivated
black grouse	Phrase
plate	Unmotivated
stately home evaporated with	Phrase
of metal-the ferrule-is	Phrase
pack	Unmotivated
her pad	Phrase
cell	Unmotivated
widow more easily	Phrase
tongue	Unmotivated
sketch	Unmotivated
ring	Unmotivated
news	Unmotivated
trifle	Derivative
bait	Unmotivated
backyard	Compound
line	Unmotivated
little wrinkle	Phrase
wanderer touched little	Phrase
cup	Unmotivated
beauty	Derivative
compressor	Derivative
tavern	Unmotivated
old percy	Phrase
manger	Derivative
prince realm	Phrase
calf	Unmotivated
foot	Unmotivated
notebook	Compound
ball of	Phrase
stemware	Compound
church	Unmotivated
box	Unmotivated
sweetmeat	Compound
sprout	Unmotivated
student	Derivative
right rain	Phrase
side	Unmotivated
train	Unmotivated
planetoid	Derivative
handkerchief	Compound
precinct	Derivative
face	Unmotivated
button	Unmotivated
hour	Unmotivated
fountain	Unmotivated
palmer houses portiered	Phrase
allowances	Derivative
cushion	Unmotivated
lady	Derivative
cake	Unmotivated
finger	Derivative
buoy	Derivative
chapel	Unmotivated
pill	Unmotivated
carbon	Unmotivated
tablet	Derivative
strip	Unmotivated
dimple	Derivative
stream	Unmotivated
african mantis	Phrase
hair	Unmotivated
chocolate	Unmotivated
females	Unmotivated
breast	Unmotivated
sheaf of	Phrase
apple of the eye	Phrase
t-shirt	Compound
simpleton	Derivative
transformers	Unmotivated
book	Unmotivated
measles	Unmotivated
island	Compound
duck	Unmotivated
finger	Derivative
core	Unmotivated
tiny scrap	Phrase
tar	Unmotivated
shuttle	Derivative
little clerk	Phrase
handkerchief	Compound
propolis	Unmotivated
coffee	Unmotivated
channel	Unmotivated
pork sausage	Phrase
deck	Unmotivated
crescent of	Phrase
annulet	Derivative
sucking-pig	Compound
part	Unmotivated
puffball	Compound
guinea fowl	Phrase
heart	Unmotivated
worm	Unmotivated
hobby	Derivative
by-blow	Compound
serviette	Unmotivated
history-making serenade	Phrase
worker	Derivative
squirrel	Unmotivated
tendril	Unmotivated
poor little creature	Phrase
bundle	Derivative
lobe	Unmotivated
crisps	Unmotivated
dog	Unmotivated
newborn child	Phrase
tryst	Unmotivated
carrot	Unmotivated
sergeant major	Phrase
satisfactory pincushion	Phrase
hammer	Phrase
shelter	Unmotivated
refrigerator	Derivative
two cents	Phrase
creature	Derivative
plate	Unmotivated
yearning	Unmotivated
card	Unmotivated
wand	Unmotivated
slipper	Derivative
cosy comfort	Phrase
little altar	Phrase
at a scab on a dirty	Phrase
legshe	Unmotivated
flower	Unmotivated
mascara run	Phrase
particle	Derivative
heel	Unmotivated
cube milkless victory	Phrase
beer	Unmotivated
forefinger	Derivative
pericranium	Derivative
statue of	Phrase
cheek	Unmotivated
grandmother	Compound
monitor	Unmotivated
take	Unmotivated
percentage	Derivative
sweetmeat	Compound
rose hip	Phrase
hook	Unmotivated
old woman	Phrase
bird	Unmotivated
ticket	Unmotivated
house	Unmotivated
barghest	Unmotivated
small window	Phrase
ribbon	Unmotivated
fish	Derivative
whiplash	Compound
puppy	Derivative
tall man	Phrase
primer-black cap	Phrase
flame	Unmotivated
pocket	Unmotivated
room	Unmotivated
small hoe	Phrase
village	Unmotivated
turtle	Derivative
stick	Unmotivated
subgroup	Derivative
leaves	Unmotivated
silex	Unmotivated
door post	Phrase
kind	Unmotivated
little refuge	Phrase
teapot	Compound
flock	Unmotivated
figure	Unmotivated
rapeseed	Compound
receptacle	Derivative
channel	Unmotivated
palestinian hanging	Phrase
hat	Unmotivated
nail	Unmotivated
minute	Unmotivated
snack	Unmotivated
purse	Unmotivated
fry	Derivative
sodium	Unmotivated
bodyafter	Compound
spark	Unmotivated
potato	Unmotivated
part	Unmotivated
his haunches	Phrase
head	Unmotivated
mother	Unmotivated
there a level space	Phrase
finger	Derivative
calling card	Phrase
dagger	Unmotivated
chicken	Unmotivated
blue tit	Phrase
peach	Unmotivated
room	Unmotivated
bottom	Unmotivated
glass	Unmotivated
mole	Derivative
string	Unmotivated
young man	Phrase
bootie	Derivative
pack	Unmotivated
girl	Unmotivated
barn owl	Phrase
baby donkey	Phrase
femur	Unmotivated
person	Unmotivated
clock	Unmotivated
doctor	Unmotivated
little man	Phrase
equisetum	Unmotivated
stall	Unmotivated
young goat	Phrase
drinking straw	Phrase
little park	Phrase
problem	Derivative
coolness	Derivative
gadget	Unmotivated
cup	Unmotivated
figure	Unmotivated
lopsided crippled set	Phrase
some beautiful little girl	Phrase
dazzlers	Compound
old man	Phrase
suit	Unmotivated
treasure trove	Phrase
cathe	Unmotivated
deep freezer	Phrase
tea-strainer	Compound
steamer	Derivative
end of his	Phrase
pilot burner	Phrase
pond	Unmotivated
unit	Unmotivated
comb	Unmotivated
mountings	Derivative
handle	Derivative
pumpkin	Derivative
young sapling	Phrase
shop	Unmotivated
lollypop	Derivative
stake	Unmotivated
door	Phrase
common hazel	Phrase
notebook	Compound
curlicue	Unmotivated
thread upon	Phrase
body	Derivative
people	Derivative
triangle of	Phrase
emergency department	Phrase
letter	Unmotivated
hook	Unmotivated
rivet at the bottom where started	Phrase
room is	Phrase
cube	Unmotivated
fit	Unmotivated
period	Unmotivated
nose	Unmotivated
aisle	Derivative
archbishoples	Compound
gate	Unmotivated
room	Unmotivated
mistake	Unmotivated
fall	Unmotivated
trousers	Derivative
rod and his ferule were seldom idle	Phrase
horse	Unmotivated
this little paragraph sir	Phrase
site	Unmotivated
shelf	Unmotivated
paws	Unmotivated
mole	Derivative
chop	Unmotivated
act	Unmotivated
work	Unmotivated
eye lens	Phrase
humper	Unmotivated
primrose	Derivative
kajigger	Derivative
bulb	Unmotivated
chief	Unmotivated
nugget of	Phrase
cot	Unmotivated
neckband	Compound
stretcher	Derivative
ursids	Unmotivated
radishes	Unmotivated
mount	Unmotivated
train	Unmotivated
lesbian	Phrase
board	Unmotivated
creep	Unmotivated
dragon-fly	Compound
basket	Unmotivated
holiday	Derivative
relief	Unmotivated
death bell	Phrase
barghest	Unmotivated
footpath	Compound
methyl vanillin	Phrase
small saucepan a	Phrase
valve	Unmotivated
tittle	Derivative
of the legs	Phrase
marshal	Phrase
fibre	Unmotivated
vindictive set	Phrase
aluminium	Unmotivated
seed	Unmotivated
spinning top	Phrase
cauldron	Compound
segment	Unmotivated
youngster	Unmotivated
tuft of	Phrase
doughnut	Compound
disk	Unmotivated
butt hinge	Phrase
chance	Unmotivated
bundle	Derivative
garden	Unmotivated
stranger	Derivative
cemetery	Derivative
-stroke	Compound
delicate little thing set	Phrase
eyebrow	Compound
pansies	Derivative
bait	Unmotivated
switch	Unmotivated
package	Derivative
mummy	Derivative
knee	Unmotivated
line	Unmotivated
note	Unmotivated
airline	Compound
all your philosophizing	Phrase
physic finger	Phrase
iron wire	Phrase
common daisy	Phrase
foal	Unmotivated
poin of intersection	Phrase
ovine	Unmotivated
cotton bud	Phrase
twig	Unmotivated
vessel	Unmotivated
apple	Derivative
bitch	Unmotivated
windburned man	Phrase
cave	Unmotivated
arbor	Phrase
little dog skipped after	Phrase
straw floating	Phrase
suit	Unmotivated
favour	Unmotivated
thumbtack	Compound
books shelves a	Phrase
duck	Unmotivated
nut to crack	Phrase
thin tin	Phrase
hanger	Derivative
jacket	Derivative
sliver of	Phrase
cloth	Unmotivated
flower bed	Phrase
seamstress	Derivative
cup	Phrase
aisle	Derivative
tatee	Derivative
poodle	Derivative
ornery lot	Phrase
machine gunner	Phrase
bracelet	Derivative
radicle	Derivative
pointer	Derivative
flag	Unmotivated
word	Unmotivated
wars	Unmotivated
hydrogen	Unmotivated
tympanic cavity	Phrase
whistle	Derivative
little man	Phrase
family	Derivative
ladder	Unmotivated
young lady	Phrase
slurry	Derivative
muzzle	Derivative
loop 3	Phrase
wine	Unmotivated
powder	Unmotivated
friend	Unmotivated
meat	Unmotivated
stepchild	Compound
grandfather	Compound
tag	Unmotivated
dog	Unmotivated
lightline	Compound
jacket	Derivative
card	Unmotivated
roller	Derivative
pig	Unmotivated
treat	Unmotivated
handbarrow	Compound
briefcase	Compound
bunch	Unmotivated
front	Unmotivated
clothespin	Compound
setup	Unmotivated
pellet	Derivative
sugar	Unmotivated
cheek	Unmotivated
platform	Compound
old man	Phrase
box	Unmotivated
cookfire	Compound
grape	Unmotivated
tea	Unmotivated
infancy	Derivative
bottle	Derivative
slot	Unmotivated
little girl	Phrase
half an hour	Phrase
sword lily	Phrase
trollop	Unmotivated
column	Unmotivated
bag	Unmotivated
heat	Unmotivated
father	Unmotivated
loin	Unmotivated
booklet	Derivative
sweet-smelling bush	Phrase
meeting	Unmotivated
results	Unmotivated
ladder	Unmotivated
bowler	Unmotivated
great-grandfather	Compound
faerie	Derivative
fool	Unmotivated
tree	Unmotivated
book	Unmotivated
quite coony baby	Phrase
formula encompassed	Phrase
crybaby	Derivative
widget	Unmotivated
diprotodon	Derivative
old man up	Phrase
crop	Unmotivated
chicken	Unmotivated
song	Unmotivated
deficit	Derivative
village	Unmotivated
publishing	Unmotivated
place	Unmotivated
pile of	Phrase
case	Unmotivated
trefoil	Derivative
rubber band	Phrase
square	Unmotivated
treasure trove	Phrase
wand	Unmotivated
thong	Unmotivated
hair	Unmotivated
scene has now reached its high point	Phrase
sample	Derivative
business	Derivative
platform	Compound
treat	Unmotivated
cluster	Phrase
mirror	Unmotivated
bridge	Unmotivated
then this good old man	Phrase
group of	Phrase
taxi	Unmotivated
chock	Unmotivated
article	Derivative
mood	Unmotivated
plant	Unmotivated
cock-a-doodle-doo	Compound
this comedy prettily	Phrase
whirr motor	Phrase
girl	Unmotivated
girl-ish	Compound
blighter	Derivative
ampoule	Derivative
belly	Derivative
tree	Unmotivated
you were a bud	Phrase
bar	Unmotivated
parcel	Unmotivated
tailor	Unmotivated
baby angel	Phrase
little riding hood	Phrase
goat	Unmotivated
husband	Unmotivated
corpse	Unmotivated
nose	Unmotivated
grilled dish	Phrase
blouse	Unmotivated
pension	Unmotivated
paper	Unmotivated
fork	Unmotivated
spokeshave	Compound
cake	Unmotivated
bubble	Derivative
fire	Unmotivated
small valley	Phrase
piece	Unmotivated
piece of	Phrase
squirrel	Unmotivated
strip	Unmotivated
vodka	Derivative
vole	Derivative
machine	Unmotivated
vesicle	Derivative
baby	Derivative
fire-truck	Derivative
cigar	Derivative
spot	Unmotivated
was a grain	Phrase
weathercock	Compound
box	Unmotivated
small wood	Phrase
cookie	Derivative
princess	Derivative
bonnet which	Phrase
manacles	Unmotivated
little room	Phrase
mess	Unmotivated
briefcase	Compound
cellar	Unmotivated
rhyme	Unmotivated
poor thing	Phrase
wrinkle a	Phrase
stick	Unmotivated
young novice has	Phrase
cocoon	Unmotivated
cup	Unmotivated
sausage instead	Phrase
clipboard	Compound
lectern	Unmotivated
ointment	Derivative
brush	Unmotivated
helicopter	Derivative
stamps	Unmotivated
pollination chamber	Phrase
harlequin ladybird	Phrase
wood	Unmotivated
sweater	Derivative
cottage	Derivative
weight	Unmotivated
stall	Unmotivated
poor thing	Phrase
woman walked	Phrase
ragamuffin variety	Phrase
wake-up call	Phrase
detail	Unmotivated
until tuesday evening	Phrase
standing salt	Phrase
grandmother	Compound
sucking-pig	Compound
prawn	Unmotivated
exquisity	Derivative
couple	Derivative
thing	Unmotivated
specialty	Derivative
romance	Unmotivated
wizened fellow	Phrase
cosset	Unmotivated
moment	Unmotivated
up balcony tracing	Phrase
ambulance	Unmotivated
yeast fungus	Phrase
loaf	Unmotivated
swiveling top	Phrase
affair	Unmotivated
stretcher	Derivative
homework	Compound
spare part	Phrase
last ounce	Phrase
little donkey	Phrase
note	Unmotivated
little flame	Phrase
trace anywhere	Phrase
peas	Unmotivated
football-jersey	Compound
father	Unmotivated
silhouette	Unmotivated
magazine	Unmotivated
storm	Unmotivated
pepper	Derivative
knoll	Unmotivated
flammable possessions	Phrase
monkey	Derivative
pit of theirs	Phrase
crowfoot	Compound
square of	Phrase
stack of	Phrase
glass	Unmotivated
wife	Unmotivated
face	Unmotivated
handpumps	Compound
coat	Unmotivated
bird	Unmotivated
grin	Unmotivated
cereal	Unmotivated
little washing-stand	Phrase
box of	Phrase
beak	Unmotivated
bodice	Unmotivated
midget	Derivative
small star	Phrase
chyrsler	Derivative
gates	Unmotivated
saucer	Derivative
hotel	Unmotivated
flour	Unmotivated
place	Unmotivated
corn	Unmotivated
calling card	Phrase
playpen	Compound
crutch	Unmotivated
cloud	Unmotivated
moment	Unmotivated
could a canary	Phrase
shish	Derivative
subtitle	Derivative
mouse	Unmotivated
little sister	Phrase
cheer	Unmotivated
bowl	Unmotivated
security	Derivative
box	Unmotivated
chest of drawers	Phrase
narrators	Derivative
apartment	Derivative
soiree	Derivative
flower	Unmotivated
withdraws a small bag made	Phrase
nose	Unmotivated
reason	Unmotivated
landscape	Compound
head of	Phrase
bloke	Unmotivated
twelve-year-old flame	Phrase
candle	Derivative
plate	Unmotivated
wreath	Unmotivated
slice of	Phrase
prostitute	Unmotivated
lotion	Unmotivated
car	Unmotivated
spot of	Phrase
wrinkle	Derivative
workup	Unmotivated
bird that has	Phrase
lamb	Unmotivated
joke	Unmotivated
letter	Unmotivated
voice	Unmotivated
plastice	Derivative
hoax	Unmotivated
mantle	Derivative
ash-trays where you touch	Phrase
3v2 volume	Phrase
square	Unmotivated
whisker	Derivative
carbon	Unmotivated
marker	Unmotivated
tail	Unmotivated
smaller glass	Phrase
legend	Unmotivated
steer	Phrase
tear	Unmotivated
prayer	Derivative
violin	Unmotivated
top	Unmotivated
child	Unmotivated
pimply little jew he used to be	Phrase
flyer	Derivative
back teeth	Phrase
space conceivably	Phrase
depression	Derivative
step	Unmotivated
meaning model boat	Phrase
toothbrush	Compound
teeny	Derivative
thedog	Compound
rabbit	Unmotivated
chair	Unmotivated
pitcher	Derivative
hose	Derivative
trollop	Unmotivated
bracket	Unmotivated
bunny rabbit	Phrase
cottage	Derivative
hand	Unmotivated
passage might do	Phrase
sun	Unmotivated
kokanee	Derivative
voicebox	Compound
woodbox meantime	Phrase
spoon	Unmotivated
cigarette	Derivative
window-washer stuff	Phrase
cloud	Unmotivated
cup	Unmotivated
some trifle	Phrase
dog	Unmotivated
slice	Unmotivated
hurdy-gurdy	Compound
mousetrap	Compound
honey	Derivative
refrigerator	Derivative
bow	Unmotivated
squirrel	Unmotivated
cat	Unmotivated
light	Unmotivated
pencil	Unmotivated
shoestring	Compound
needle	Derivative
priest	Unmotivated
newborn child	Phrase
blossom	Unmotivated
fist	Unmotivated
table	Derivative
place	Unmotivated
used that joke before	Phrase
money	Derivative
liver as food	Phrase
cashbox	Compound
silicon	Unmotivated
priest	Unmotivated
height	Unmotivated
kingfisher	Compound
pumpkin	Derivative
step	Unmotivated
summerhouse	Compound
whetstone	Compound
drinking straw	Phrase
vaccinium vitis-idaea	Phrase
carnation	Derivative
place	Unmotivated
blood corpuscle	Phrase
pool	Unmotivated
freshe	Derivative
coffee	Unmotivated
manacles	Unmotivated
nozzle	Derivative
individual	Unmotivated
little lantern set	Phrase
footpath	Compound
bottom	Unmotivated
person will keep alive a young cow	Phrase
grin	Unmotivated
head	Unmotivated
dove	Unmotivated
word	Unmotivated
goose	Unmotivated
area rug	Phrase
homemaker	Compound
bundle	Derivative
fetus	Unmotivated
sprig	Unmotivated
thread	Unmotivated
chair	Unmotivated
giftie	Derivative
hyphenate	Derivative
ribbon	Unmotivated
shop	Unmotivated
leg	Unmotivated
next day	Phrase
little man	Phrase
baked goods	Phrase
berries	Unmotivated
brother	Unmotivated
frigate	Unmotivated
uncle	Derivative
saucepan	Compound
small flag	Phrase
eurasian jay	Phrase
writing	Unmotivated
scout	Unmotivated
bench	Unmotivated
top	Unmotivated
room	Unmotivated
schoolboy	Derivative
gypsies	Derivative
clamp	Unmotivated
sneering	Unmotivated
caryopsis	Unmotivated
paeony	Derivative
great-grandparent	Compound
dynamics	Derivative
little kid	Phrase
propped aeroplane up	Phrase
quirk	Unmotivated
devils	Unmotivated
box	Unmotivated
map	Unmotivated
busboy	Derivative
girl	Unmotivated
corticosteroid	Compound
game	Unmotivated
word of wisdom	Phrase
sanctuary	Derivative
pimple	Derivative
ash pulverized	Phrase
hour	Unmotivated
basket	Unmotivated
roll	Unmotivated
woman	Unmotivated
lodge	Unmotivated
ticket	Unmotivated
frog	Unmotivated
girl	Unmotivated
shower of	Phrase
baby carriage	Phrase
dance	Unmotivated
slut	Derivative
8 horse closer	Phrase
half of	Phrase
wardrobe	Compound
little chap has	Phrase
breasts	Unmotivated
face	Unmotivated
droplet	Derivative
ripple	Derivative
wiener dog	Phrase
urethras	Compound
town	Unmotivated
hairnet	Compound
trays	Unmotivated
