glace	Unmotivated
girofle	Unmotivated
niche	Phrase
pièce	Unmotivated
cour	Unmotivated
chapardeur	Derivative
balourd	Unmotivated
somme	Unmotivated
balle	Derivative
herbe	Unmotivated
ermite	Unmotivated
accent circonflexe	Phrase
nuque	Unmotivated
herbe	Unmotivated
son âme confiante	Phrase
bouquet dansait	Phrase
sa place quittai le	Phrase
siège de toilettes	Phrase
moulin	Unmotivated
poêle	Unmotivated
chatte	Derivative
vésicule	Unmotivated
tête	Unmotivated
seul brin	Phrase
hache-viande	Derivative
petit garçon	Phrase
vache	Unmotivated
salle de lecture	Phrase
wikipatch	Compound
petit soldat	Phrase
écusson	Derivative
carbone	Unmotivated
gamin	Phrase
auditorium	Unmotivated
événement	Phrase
épinglette	Derivative
camionnette	Derivative
pitchous	Derivative
pâquerette	Derivative
explication	Derivative
menotte	Derivative
représentation	Derivative
poireau	Derivative
troupe	Unmotivated
couverture	Derivative
filet	Derivative
copain	Unmotivated
case	Phrase
suicide	Unmotivated
corsage	Derivative
serre-tête	Derivative
canal	Unmotivated
tableau	Derivative
régime	Unmotivated
petite maman	Phrase
chanteur	Derivative
cousin	Unmotivated
chrysomèle	Derivative
balayette	Derivative
violette	Derivative
ménagère	Derivative
table	Unmotivated
sentier	Unmotivated
tasse	Unmotivated
belette soient mêmes	Phrase
muffin	Unmotivated
poignée	Phrase
filet	Derivative
patte	Derivative
mâle	Phrase
fils	Unmotivated
pierre de lune	Phrase
grand-mère	Derivative
bouteille	Derivative
moment	Unmotivated
poitrine	Derivative
relation d’ordre	Phrase
cinéma	Unmotivated
jardin d’enfants	Phrase
lingerie	Derivative
pointe	Unmotivated
vocabulaire	Derivative
loupiote	Derivative
caca	Unmotivated
perle lui furent donnés	Phrase
minou	Derivative
croche	Derivative
grille	Derivative
clown	Unmotivated
mon petit lait chaud	Phrase
vis nickelée	Phrase
plan	Unmotivated
boîte	Unmotivated
cochon	Derivative
tata	Unmotivated
rose	Unmotivated
insecte comprenait	Phrase
parasol	Compound
rainette	Derivative
tétras lyre	Phrase
boîte	Unmotivated
pavillon grouillait cobras	Phrase
couronne ducale	Phrase
son sac à dos	Phrase
bloc papier	Phrase
mitard	Derivative
veuve	Phrase
langue la	Phrase
brouillon	Derivative
bague	Unmotivated
nouveauté	Derivative
joli colifichet	Phrase
héron	Derivative
territoire	Derivative
tube	Unmotivated
mignon	Derivative
voyageur égaré présentiez aucun intérêt	Phrase
gobelet	Derivative
beauté	Derivative
compresseur	Derivative
bar	Unmotivated
vieux bonhomme	Phrase
crèche	Unmotivated
prince	Unmotivated
ton veau tout descendu	Phrase
patte	Derivative
carnet	Derivative
peloton laine	Phrase
bois	Unmotivated
petite église	Phrase
vieil écrin contenant	Phrase
bonbon	Derivative
bourgeon	Derivative
petit étudiant	Phrase
gardon	Derivative
côté	Unmotivated
train	Unmotivated
astéroïde	Derivative
petit mouchoir	Phrase
circonscription	Derivative
visage	Derivative
bouton	Derivative
heure	Unmotivated
fontaine	Unmotivated
petite chandelle cire	Phrase
quotas	Unmotivated
petit oreiller	Phrase
dame mûre	Phrase
scones beurrés servis par	Phrase
eastland	Compound
bouã	Derivative
chapelle	Derivative
pilule	Unmotivated
carbone	Unmotivated
écusson	Derivative
bodruche	Unmotivated
fossette	Derivative
ruisseau	Derivative
mante	Unmotivated
cheveu	Unmotivated
chocolat	Unmotivated
femelle	Derivative
trayon	Derivative
liasse	Phrase
poupée	Derivative
chemise	Unmotivated
serin bêtasse	Phrase
transformateurs	Derivative
petit livre	Phrase
rougeole	Phrase
île	Unmotivated
canard	Unmotivated
ondemètre	Derivative
moelle osseuse	Phrase
nouvelle fit renaître un frêle	Phrase
ventilo	Derivative
navette	Derivative
petit fonctionnaire	Phrase
bientôt son mouchoir	Phrase
propolis	Unmotivated
petit café	Phrase
rainure	Derivative
saucisse	Unmotivated
liasse de	Phrase
croissant de la	Phrase
anneau	Derivative
porcelet	Derivative
dispositif	Derivative
boviste	Derivative
pintade	Compound
cœur	Unmotivated
bonbon	Derivative
passe-temps	Derivative
bâtard	Unmotivated
serviette	Derivative
sérénade leur offrant	Phrase
abeille	Derivative
écureuil	Unmotivated
vrille	Derivative
très pauvre homme sanglota -t-il	Phrase
petite boule aurait dû	Phrase
lobe	Unmotivated
chips	Unmotivated
chien	Unmotivated
nourisson	Derivative
rendez-vous	Compound
carotte	Derivative
mon adjudant-chef	Phrase
pelote recroqueville	Phrase
marteau	Derivative
petit auvent	Phrase
réfrigérateur	Derivative
bout	Phrase
créature	Derivative
réchauds	Unmotivated
désir ardent	Phrase
vide	Unmotivated
baguette magique	Phrase
petit soulier	Phrase
commode	Unmotivated
petit autel	Phrase
petite croûte	Phrase
sanctuaire	Derivative
fleurette	Derivative
quand le mascara coulait avec ses	Phrase
particule	Unmotivated
quignon	Derivative
quignon un carré	Phrase
verre	Unmotivated
son index	Phrase
crâne	Unmotivated
statue	Unmotivated
moitié	Unmotivated
grand-mère	Derivative
babyphone	Compound
chiffre	Unmotivated
pourcentage	Derivative
sucrerie	Derivative
rose	Unmotivated
caron	Derivative
vieille femme	Phrase
abeille	Derivative
références	Unmotivated
château	Derivative
sylphe	Unmotivated
lucarne	Unmotivated
ruban	Unmotivated
poisson	Derivative
corde	Unmotivated
petit bichon frisé	Phrase
médius	Unmotivated
toque bien vissée	Phrase
flamme	Unmotivated
poche	Derivative
réduit minuscule	Phrase
houe	Unmotivated
village	Unmotivated
tortue	Unmotivated
mince une tige saule	Phrase
sous-groupe	Derivative
sentit une fine aiguille lui choir	Phrase
silex	Unmotivated
colonne	Derivative
monde	Unmotivated
petit repaire déplaît	Phrase
petit pot	Phrase
troupeau	Derivative
personnage	Derivative
colza	Unmotivated
bassin	Unmotivated
strie	Unmotivated
poulie mouflée	Phrase
chapeau	Derivative
clou	Unmotivated
moment	Unmotivated
faim	Unmotivated
sac	Unmotivated
frite	Unmotivated
sodium	Unmotivated
main-bras	Compound
petite étincelle	Phrase
chips	Unmotivated
rôle	Unmotivated
moquette	Derivative
sommet	Derivative
sa mère fût si	Phrase
il y avait un espace plan	Phrase
petit doigt	Phrase
adaptateur	Derivative
croix	Unmotivated
poussin	Unmotivated
mésange bleue	Phrase
pêche	Unmotivated
pièce minuscule avec entre-deux	Phrase
point	Unmotivated
verre	Unmotivated
type signe	Phrase
cordon	Derivative
petit jeune homme	Phrase
botte	Derivative
twinkie	Derivative
petite fille	Phrase
chouette	Derivative
forme pour une	Phrase
aile	Unmotivated
personnage	Derivative
montre	Unmotivated
médecin	Unmotivated
petit orteil	Phrase
equisetum	Unmotivated
stand	Unmotivated
cabri	Phrase
paille	Derivative
square	Unmotivated
problème	Unmotivated
fraîcheur	Derivative
machine	Unmotivated
gobelet	Derivative
personnage	Derivative
petit infirme	Phrase
angelot	Derivative
rose	Unmotivated
petit vieillard	Phrase
vêtement	Derivative
amante	Unmotivated
zérène	Derivative
congélateur	Derivative
tamis	Phrase
vapeur	Derivative
bout	Unmotivated
brûleur de pilote	Phrase
mare	Unmotivated
unité	Unmotivated
peigne paraîtrait minuscule	Phrase
monture	Derivative
bouton	Derivative
citrouille	Derivative
petite pousse	Phrase
parfumerie un petit	Phrase
grand-magasin	Derivative
pal	Unmotivated
portière	Phrase
noisetier commun	Phrase
carnet	Derivative
boucle	Unmotivated
araignées les subtiles laissent fil trop	Phrase
corps	Unmotivated
peuple	Unmotivated
sur portait un triangle	Phrase
ambulance	Unmotivated
lettre	Phrase
nœud	Unmotivated
clou	Unmotivated
chambrette	Derivative
cube	Unmotivated
forme	Unmotivated
durée	Derivative
petit nez	Phrase
impasse	Derivative
archevêques	Unmotivated
porte	Derivative
chambre	Unmotivated
défaut	Unmotivated
automne	Unmotivated
culotte	Derivative
avait demanda harry déconcerté	Phrase
pouliche	Unmotivated
faits divers	Phrase
réchauffer petit lit	Phrase
étagère	Derivative
main	Unmotivated
grain beauté	Phrase
porc	Unmotivated
numéro	Unmotivated
pour préparer coup	Phrase
membrane nictitante	Phrase
grillage	Derivative
primevère	Unmotivated
dispositif	Derivative
oignon	Derivative
chef	Unmotivated
motte	Derivative
lit d’enfant	Phrase
col	Unmotivated
petit chariot	Phrase
ours en peluche	Phrase
radis	Unmotivated
carton	Derivative
machine	Unmotivated
lesbienne pas vrai	Phrase
siège	Unmotivated
valet de ferme	Phrase
odonatoptères	Derivative
panier	Phrase
vacance	Derivative
portrait	Unmotivated
glas	Unmotivated
sylphe	Unmotivated
sentier pour piétons	Phrase
vanille	Derivative
petite casserole	Phrase
petite aile	Phrase
petit morceau	Phrase
ta patte	Phrase
maréchal	Phrase
filament	Unmotivated
traînent gens	Phrase
aluminium	Unmotivated
graine de cachée	Phrase
toupie	Unmotivated
chaudron	Derivative
segment	Unmotivated
petit jeune	Phrase
petite touffe	Phrase
aqua-terrarium	Derivative
disque	Unmotivated
couvercle	Unmotivated
hasard	Unmotivated
paquet	Derivative
jardin potager	Phrase
moisiversaire	Derivative
cimetière	Derivative
mini-attaque	Derivative
air	Unmotivated
sourcil	Unmotivated
pensée	Derivative
appât	Unmotivated
bouton	Derivative
matériel d’emballage	Phrase
mère	Unmotivated
genou	Derivative
ligne	Unmotivated
note	Unmotivated
compagnie aérienne	Phrase
couleur	Derivative
doigt annulaire	Phrase
fil de fer	Phrase
pâquerette	Derivative
pouliche	Unmotivated
intersection	Derivative
mouton	Derivative
bâtonnet ouaté	Phrase
branche	Unmotivated
flacon	Derivative
tomate	Phrase
chienne	Phrase
courtaud	Phrase
grotte	Derivative
tonnelle	Derivative
chien	Unmotivated
surveillez vos bouchons	Phrase
tailleur	Derivative
besoin	Derivative
badge	Unmotivated
minimum une petite bibliothèque	Phrase
canard	Unmotivated
noisette	Derivative
vibra une plaque	Phrase
cintre	Unmotivated
veste	Unmotivated
éclats	Phrase
tissu exposé	Phrase
sécheresse qui saccagea carré	Phrase
cousette	Derivative
tasse	Phrase
navire	Unmotivated
tata	Unmotivated
petit loulou	Phrase
quel micmac	Phrase
mitrailleur vient	Phrase
collier	Unmotivated
racine	Derivative
aiguille	Derivative
drapeau	Derivative
mot	Derivative
guerres	Unmotivated
hydrogène	Compound
ballon	Derivative
sifflet	Derivative
petit homme	Phrase
petite famille	Phrase
échelle	Derivative
petite demoiselle	Phrase
botte	Derivative
bâillon	Derivative
corde	Unmotivated
vin	Unmotivated
poudre	Unmotivated
tes copains scout	Phrase
viande	Unmotivated
pignon	Derivative
grand-père	Derivative
étiquette	Derivative
chien	Unmotivated
orthopédie	Unmotivated
paletot	Derivative
carte	Unmotivated
rouleau à pâtisserie	Phrase
cochon	Derivative
faete	Unmotivated
galet	Derivative
mallette	Derivative
partie	Unmotivated
couverture	Derivative
cheville	Derivative
piège	Unmotivated
pastille	Derivative
sucre	Unmotivated
fesse	Unmotivated
podium	Unmotivated
pépé	Phrase
cadre	Unmotivated
biche	Unmotivated
raisin	Unmotivated
thé	Unmotivated
début	Unmotivated
fiole	Unmotivated
douille	Derivative
fillette	Derivative
demi-heure	Derivative
glaïeul	Derivative
pute	Unmotivated
colonne	Derivative
spécialité	Derivative
chaleur	Derivative
père	Unmotivated
échine	Unmotivated
toujours pages disaient quelque chose	Phrase
buisson	Derivative
rendez-vous	Compound
résultats	Derivative
classement	Derivative
chapeau melon	Phrase
arrière grand père	Phrase
sylphe	Unmotivated
petite folle	Phrase
sapin	Unmotivated
livre	Unmotivated
petit nègre	Phrase
formule	Phrase
pleurnicheur	Derivative
dispositif	Derivative
péristalithe	Derivative
petit papa	Phrase
cravache	Unmotivated
poule	Unmotivated
chanson	Derivative
déficit	Unmotivated
hameau	Derivative
étrange troupe	Phrase
petit bunker en	Phrase
pile de	Phrase
mallette	Derivative
trèfle	Unmotivated
pastille un fil caoutchouc	Phrase
placette	Derivative
amante	Unmotivated
baguette	Derivative
harde	Unmotivated
cheveu	Unmotivated
tableau la idéale atteint la perfection	Phrase
mesure	Unmotivated
travail	Unmotivated
plate-forme	Derivative
ménag	Derivative
couronnée un bouquet	Phrase
glace	Unmotivated
chevalet	Derivative
comprit très bien ce petit chéri	Phrase
groupe	Phrase
taxi	Unmotivated
coin	Unmotivated
article	Unmotivated
humeur	Unmotivated
volera -t-elle la pauvre plante	Phrase
robinet d’arrêt	Phrase
retour	Unmotivated
motos	Unmotivated
servante	Derivative
pyj	Unmotivated
type	Unmotivated
ampoule remplie	Phrase
bidon	Derivative
sapin	Unmotivated
boutons hors ceux	Phrase
placé barre	Phrase
paquet de la poste	Phrase
tailleur	Derivative
chérubin	Unmotivated
petit chaperon rouge	Phrase
chèvre	Unmotivated
mari	Unmotivated
cadavre	Unmotivated
petit nez	Phrase
compte-minutes	Derivative
chemise	Unmotivated
pension	Derivative
papier	Derivative
fourchette	Derivative
rabot	Derivative
gâteau	Derivative
bulle	Derivative
peu feu	Phrase
vallée	Derivative
miette	Derivative
cigare à	Phrase
écureuil	Unmotivated
tranche	Unmotivated
alcool de bouche	Phrase
campagnol	Derivative
outilleur	Derivative
vésicule	Unmotivated
compagnie	Derivative
mini-parc	Derivative
petit cigare	Phrase
tache	Unmotivated
grain	Unmotivated
banderole	Unmotivated
siège	Phrase
boqueteau	Derivative
moule	Unmotivated
princesse	Derivative
coiffe	Phrase
menottes	Unmotivated
pièce aussi	Phrase
pétaudière	Phrase
mallette	Derivative
oignons	Unmotivated
couplet inintelligible	Phrase
pauvre	Phrase
hobbit envelopper un petit	Phrase
bâton	Derivative
-ci notre moinillon	Phrase
cocon	Derivative
gobelet	Derivative
saucisse	Unmotivated
broche	Derivative
pupitre	Phrase
pommade	Derivative
bâton dénudé	Phrase
hélicoptère	Derivative
coupon	Derivative
chambrette	Derivative
coccinelle asiatique	Phrase
paillasson	Derivative
sweat-shirt	Compound
chaumière	Phrase
dumb-bell	Compound
porte	Derivative
pauvre	Phrase
mignonne	Derivative
gouape	Unmotivated
réveil	Phrase
détail de	Phrase
mardi	Unmotivated
salière	Derivative
arrière-arrière-grand-mère	Derivative
porcelet	Derivative
crevette	Derivative
gourmandises	Unmotivated
couples tout	Phrase
gigantesque fumisterie	Phrase
spécialité	Derivative
petit roman	Phrase
gnome certes oui	Phrase
petit doigt	Phrase
moment	Unmotivated
petit péristyle rien	Phrase
ambulance	Unmotivated
levure	Derivative
gâteau	Derivative
gyrophare apportait	Phrase
relation	Derivative
civière	Unmotivated
devoirs à la maison	Phrase
étoffe	Unmotivated
retenir mes derniers restes familiaux	Phrase
petit âne	Phrase
feuille	Derivative
ses yeux	Phrase
tout petit lambeau	Phrase
petit pois	Phrase
tee-shirt	Derivative
père	Unmotivated
silhouette	Derivative
magazine	Unmotivated
tempête	Unmotivated
piment	Unmotivated
monticule	Derivative
saint-frusquin	Derivative
de singe était assise	Phrase
pucelle	Derivative
bouton d’or	Phrase
carré	Unmotivated
liasse	Phrase
verre	Unmotivated
petite dame	Phrase
visage trempé	Phrase
pompe	Unmotivated
fourrure	Phrase
appât	Unmotivated
grimace	Unmotivated
céréale	Unmotivated
lavabo écaillé absolument minuscule	Phrase
caisse	Phrase
bec	Unmotivated
corsage	Derivative
solero	Derivative
astérisque	Derivative
showstar	Compound
but	Unmotivated
soucoupe	Derivative
hôtel	Unmotivated
farine	Unmotivated
place	Unmotivated
grain	Unmotivated
carte	Unmotivated
parc	Unmotivated
béquille	Derivative
moindre nuage	Phrase
moment	Unmotivated
canari -il	Phrase
aubepine	Derivative
sous-titre	Derivative
souriceau	Derivative
infirmière	Derivative
blushe	Unmotivated
plateau	Derivative
sécurité dont	Phrase
caisse	Phrase
commode	Unmotivated
bavard	Unmotivated
immeuble	Unmotivated
teuf	Unmotivated
fleur	Unmotivated
petit sac contenant	Phrase
museau	Derivative
lieu	Unmotivated
soldat reconnut un jour dans cette peinture un paysage	Phrase
petit épi	Phrase
bougre	Unmotivated
ta bouche présent	Phrase
bougie	Unmotivated
plaque	Unmotivated
guirlande	Unmotivated
morceau pain	Phrase
séance-photo	Derivative
lotion	Derivative
voiture	Derivative
tache	Unmotivated
pli	Phrase
roman-photos	Compound
oisillon	Derivative
mouton	Derivative
blague	Unmotivated
lettre c	Phrase
voix	Unmotivated
interupteurs	Derivative
bonne humeur générale	Phrase
son mantelet	Phrase
voir remettre le cendrier	Phrase
opuscule	Unmotivated
cube	Unmotivated
moustache	Unmotivated
carbone	Unmotivated
marqueur	Derivative
queue	Phrase
verre à pied	Phrase
légende	Unmotivated
taurillon vint	Phrase
larme	Unmotivated
prière	Unmotivated
violon minuscule	Phrase
couvercle	Unmotivated
enfant	Unmotivated
petit juif	Phrase
prospectu	Derivative
pleine lune	Phrase
moindre ouverture	Phrase
dépression	Derivative
pas	Phrase
petite embarcation	Phrase
brosse à dents	Phrase
simili-ferme	Compound
echinos	Derivative
lapin	Unmotivated
fauteuil	Phrase
cruche	Unmotivated
tuyau d’arrosage	Phrase
cocotte	Derivative
parenthèses	Unmotivated
roitelet	Derivative
pavillon	Derivative
bras	Unmotivated
sur mètres	Phrase
soleil	Unmotivated
landais	Derivative
logciel	Compound
caisse posée à côté	Phrase
cuillère	Derivative
cigarette	Derivative
petit matériel	Phrase
nuage	Unmotivated
tasse	Unmotivated
gâteau	Derivative
chien	Unmotivated
petit détour	Phrase
vielle à roue	Phrase
souricière	Derivative
ma chérie	Phrase
réfrigérateur	Derivative
nœud	Unmotivated
écureuil	Unmotivated
chaton	Derivative
lumière	Derivative
crayon	Derivative
lacet de chaussure	Phrase
aiguille déviée	Phrase
prêtre	Unmotivated
nourisson	Derivative
fleurette	Derivative
poing	Unmotivated
table	Phrase
planette	Derivative
osée	Unmotivated
argent	Unmotivated
cervelle	Derivative
pépette	Derivative
silicium	Unmotivated
fantoche	Derivative
sommet	Derivative
martin-pêcheur	Compound
chou	Unmotivated
marche tout près	Phrase
belvédère	Unmotivated
pierre noire	Phrase
paille	Derivative
airelle à fruits rouges	Phrase
œillet de poète	Phrase
nid rapprochant	Phrase
globule	Unmotivated
lac	Phrase
pause	Unmotivated
café	Unmotivated
mari	Unmotivated
gicleur	Derivative
homme	Unmotivated
furent suspendues à toutes ses branches	Phrase
raie	Unmotivated
queue	Unmotivated
barbe aussi sera enlevée	Phrase
sourire voulait	Phrase
cône	Unmotivated
colombe	Phrase
mot	Derivative
vois une petite femelle insignifiante	Phrase
tapis	Unmotivated
trousse de couture	Phrase
ballot	Derivative
microorganisme	Derivative
bourgeon	Derivative
ruisseau	Derivative
chaise	Unmotivated
cadeau	Derivative
nom	Unmotivated
ruban	Unmotivated
boutique	Phrase
cuisse auriez mangées	Phrase
lundi fut journée	Phrase
petit bonhomme	Phrase
pain	Unmotivated
genièvre	Unmotivated
petit frère	Phrase
frégate	Unmotivated
oncle	Unmotivated
pelvis	Unmotivated
fanion	Derivative
geai bleu	Phrase
écriture courante	Phrase
scout	Unmotivated
banc	Unmotivated
cerise	Unmotivated
toilette	Derivative
écolier	Phrase
gitane	Unmotivated
clamp	Unmotivated
si moqueur	Phrase
caryopse	Unmotivated
pivoine	Unmotivated
arrière-grand-père	Derivative
dynamisme	Derivative
petit gosse	Phrase
avion	Derivative
maniérisme	Derivative
démon	Derivative
boîte	Unmotivated
carte	Phrase
groom	Unmotivated
fille	Derivative
corticostéroïde	Derivative
temps	Unmotivated
perlot	Derivative
chapelle précédée	Phrase
bouton	Derivative
fines particules rejetées par	Phrase
heure	Unmotivated
seau	Derivative
rouleau	Derivative
femme	Unmotivated
château	Derivative
billet	Derivative
grenouille	Derivative
petite fille	Phrase
pluie	Phrase
wagon	Derivative
petite ronde	Phrase
putain a donc accordé ses	Phrase
huit allongés	Phrase
moitié	Unmotivated
penderie	Derivative
petit bonhomme a sauvée	Phrase
mais vous avez de tout petits seins	Phrase
visage remonté à	Phrase
goutte	Derivative
ondelette	Derivative
saucisson à pattes	Phrase
momument	Unmotivated
bourg	Unmotivated
résille	Derivative
coupe	Unmotivated
