Eis	Unmotivated
Drahtstift	Compound
Kästchen	Derivative
Geld	Unmotivated
Garten…	Derivative
Langfinger	Compound
Dummchen	Derivative
Betrag	Unmotivated
Ball	Phrase
Kräuter	Derivative
Einsiedler	Derivative
Vordach	Compound
Kragen	Unmotivated
Geburtstagsgra	Compound
Seele	Unmotivated
verschlungen und verzehrt eine Strohgarbe	Phrase
wieder Gestell	Phrase
Schneidebrett	Phrase
Kaffeemühle	Compound
Petroleumofen	Compound
Fotze	Derivative
Bläschen	Derivative
Gesicht	Unmotivated
Grashälmchen	Derivative
Hackmesser	Compound
Junge	Unmotivated
Muh-Kuh	Compound
Lesezimmer	Compound
tabellenvorlage	Compound
Soldat	Derivative
RFID-Markierung	Compound
Kohlenstoff	Compound
kleiner Junge	Phrase
theaterraum	Compound
Veranstaltung	Derivative
Anstecker	Derivative
Pritschen wagen schon	Phrase
naturkindergarten	Compound
Marienblümchen	Derivative
Erläuterung	Derivative
Eisen	Unmotivated
Photo	Unmotivated
Schalotten	Unmotivated
zwergengruppe	Compound
Decke	Unmotivated
Strähne	Phrase
von kleinen Freund	Phrase
Feld	Unmotivated
Selbstmord	Compound
Uniformjacke	Compound
Stirnbinde	Compound
Kanälchen	Derivative
Tabelle	Unmotivated
Ernährung	Unmotivated
Mütterchen	Derivative
Singvögelchen	Derivative
Cousin	Unmotivated
Kartoffelkäfer	Compound
Handfeger	Compound
Veilchen	Derivative
Hausfrau	Compound
Tischchen	Derivative
Pfad - s	Phrase
um ihren behaglich Becher geklammert	Phrase
Wiesel	Phrase
Muffin	Derivative
Handvoll	Compound
Streifen	Unmotivated
Stelle	Unmotivated
Männchen	Derivative
Sohn	Unmotivated
Ringelblume	Compound
Oma	Unmotivated
Flasche	Unmotivated
Minute	Unmotivated
Anbieter	Compound
Ordnung	Derivative
Schauspiel	Compound
Vorschule	Compound
Damenunterwäsche	Compound
Spannungsstoß	Compound
Glossar	Derivative
Lämpchen	Derivative
Scheiße	Unmotivated
Perle	Unmotivated
Katze	Unmotivated
Achtelnote	Compound
Raster	Unmotivated
Spaßmacher	Compound
Milch	Unmotivated
Schraube	Unmotivated
Karte	Unmotivated
Blitzblank	Compound
Schweinerei	Compound
Tante	Unmotivated
Feder	Unmotivated
Geschöpf	Derivative
Schirmchen	Derivative
Wetterfrau	Compound
Birkhuhn	Compound
Spendenbüchse	Compound
Lusthaus	Compound
Krone	Phrase
Rucksack	Compound
Reichweite gewesen kein Block wenigstens	Phrase
Isolationshaft	Compound
Witwe	Unmotivated
Zunge	Unmotivated
Skizze	Unmotivated
Ring	Phrase
Neuigkeit	Derivative
Talmiware	Compound
Reiher	Derivative
Schmollmündchen	Derivative
Heftchen	Derivative
winziger Fehler	Phrase
vereinzelter Wanderer	Phrase
Tasse	Unmotivated
Äffin	Unmotivated
Kompressor	Derivative
Schankwirtschaft	Compound
schau her der Alte hat	Phrase
Krippe	Unmotivated
verhätschelter Prinz	Phrase
Kälbchen	Derivative
Hasenpfote	Compound
sein Notizbuch	Phrase
Knäuel	Unmotivated
Fuß	Unmotivated
Kirche	Unmotivated
verschließbares Kästchen	Phrase
Bonbon	Unmotivated
Schlüssel	Unmotivated
Studentlein	Derivative
Fisch	Unmotivated
Eigenschaft	Derivative
Zug	Unmotivated
Planet	Unmotivated
Taschentuch	Phrase
Kreis	Unmotivated
Gesicht	Unmotivated
Knopf auf	Phrase
Stunde	Unmotivated
Springbrunnen	Compound
verkümmertes Kerzlein dieser	Phrase
Zertifikat	Derivative
Kissen	Unmotivated
wir junge Dame könnten	Phrase
Scheibchen	Derivative
Finger	Derivative
Fischerkorb	Compound
kleine Kapelle	Phrase
Tablette	Unmotivated
Kohlenstoff	Compound
Wappenschild	Compound
schmales rechteckiges Stück weißer Karton darin	Phrase
Grübchen	Derivative
Bächlein	Derivative
Gottesanbeterin	Compound
Freischneider	Compound
Schokolade	Unmotivated
Weibchen	Derivative
Brustdrüse	Compound
einen winzigen Knäuel	Phrase
Handpuppe	Compound
Hemd	Unmotivated
zweites Dummchen wie gibt	Phrase
Transformer	Derivative
Büchlein	Derivative
Masern	Unmotivated
Insel	Unmotivated
Ente	Unmotivated
kontaktmikrofon	Compound
Knochenmark	Compound
Zipfelchen von	Phrase
netzteil	Compound
Schiffchen	Derivative
kleiner Beamter	Phrase
Tüchlein	Derivative
Kindergartenknet	Compound
Kaffee	Unmotivated
Zapfenloch	Compound
Wurst	Unmotivated
Paket	Unmotivated
Mondsichel	Compound
Blumenkette	Compound
Frischling	Derivative
nützliches Gerät	Phrase
Stäubling	Unmotivated
Helmperlhuhn	Compound
Herz	Unmotivated
Gummiwurm	Compound
Pferdchen	Derivative
uneheliches Kind	Phrase
Serviette	Unmotivated
Ständchen	Derivative
Bienchen	Derivative
Eichhörnchen	Derivative
Lachschlangen	Compound
kleine Großmaul	Phrase
Bündel	Unmotivated
Ohrläppchen	Derivative
Chip	Unmotivated
Hündchen	Derivative
Kleinkind	Compound
Stelldichein	Compound
Karotte	Unmotivated
Fähnrich	Phrase
Nadelkissen	Compound
Hammer	Phrase
Dach	Unmotivated
Eiskasten	Compound
weiteres Scheit Kamin	Phrase
Monster	Unmotivated
Vollherde	Compound
Sehnsucht	Compound
Karte	Unmotivated
Zauberstab	Compound
Schuh	Unmotivated
Kugel schieben	Phrase
kleinen Altar	Phrase
wenig Wundschorf darauf	Phrase
ritualplatz	Compound
Sträußchen	Derivative
Wimperntusche	Compound
Teilchen	Derivative
Brotkanten	Compound
Eßgeschirr voll eines rosagrauen Eintopfes Würfel	Phrase
Bier	Unmotivated
Zeigefinger	Compound
Schädel	Unmotivated
Statue	Derivative
Hälfte	Unmotivated
Großmutter	Compound
Scorpy-Sue	Compound
Nummer	Unmotivated
Prozentsatz	Compound
Süßigkeit	Derivative
Hagebutte	Compound
Häkchen	Derivative
alte Frau	Phrase
Biene	Unmotivated
Empfangsschein	Compound
Häuschen	Derivative
Elfe	Unmotivated
Fenster	Unmotivated
Bändchen	Derivative
Fisch	Unmotivated
Schnur	Unmotivated
Pinscherweibchen	Derivative
Mittelfinger	Compound
Mütze	Derivative
Flamme	Unmotivated
Stockinette	Compound
Krapfen eigentlich ein Verschlag	Phrase
Keilhaue	Compound
Dörfchen	Derivative
Schildkröte	Compound
Zauberstab	Compound
Untergruppe	Compound
Blätter der	Phrase
Feuerstein	Compound
Zauntritt	Unmotivated
Hauch	Unmotivated
Nestchen	Derivative
Kännchen	Derivative
kleine Herde	Phrase
Gestalt	Unmotivated
Futterraps	Compound
Gefäß	Unmotivated
Fensteranschlag	Compound
Flaschenzug	Compound
Kappe	Unmotivated
Nagel	Phrase
Augenblick	Compound
Frühstückscerealie	Compound
Tasche	Unmotivated
Pommes-Frites-Brater	Compound
Natrium	Unmotivated
wunschinstrument	Compound
Funken	Unmotivated
Chip	Unmotivated
Rolle	Derivative
Hocke	Phrase
Gipfel	Unmotivated
Mutter	Unmotivated
kam ein ebenes Stück	Phrase
Fingerchen weggedrückt	Phrase
Visitenkarte	Compound
Kreuz	Unmotivated
Kükenkopf	Compound
Blaumeise	Compound
Herzblatt	Compound
Zimmerchen	Derivative
Podex Popo	Phrase
Glassplitter	Compound
Muttermal	Compound
Schnur	Unmotivated
Jüngling	Derivative
Babyschuh	Compound
Kuchen	Derivative
Mädchen	Derivative
Steineule	Compound
Pferdefuß lag	Phrase
Schulterblatt	Compound
Person	Unmotivated
Uhr	Unmotivated
Arzt	Unmotivated
kleiner Finger	Phrase
Schachtelhalm	Compound
Zeitungskiosk	Compound
Teufel herum Zickel	Phrase
Trinkröhrchen	Derivative
Grünanlage	Compound
Problem	Unmotivated
Kühle	Unmotivated
nützliches Gerät	Phrase
Becher	Phrase
Figur	Unmotivated
stolpernden Schritten	Phrase
Engelchen	Derivative
Marzipanblumen	Compound
Alte	Phrase
Kostüm	Unmotivated
Liebling	Derivative
alpenpflanze	Compound
Eiskasten	Compound
Teesieb	Phrase
Hausboot	Compound
führte die Spitze	Phrase
Pilotbrenner	Compound
kleine Ententeich	Phrase
Einheit	Derivative
Kamm	Phrase
Brillenfassung	Compound
Schalter	Derivative
Dummerle	Unmotivated
Sämling	Unmotivated
Laden	Unmotivated
sonderpostenmarkt	Compound
Pflock	Unmotivated
Tür	Phrase
Nußsträucher	Compound
Heft	Unmotivated
Geschnörkel	Unmotivated
Faden	Unmotivated
Körper	Unmotivated
Leute	Unmotivated
Dreieck	Compound
Notarztwagen	Compound
Briefchen	Derivative
Schlinge	Unmotivated
vertraute Nagelkopf	Phrase
Zimmer	Unmotivated
Würfel	Unmotivated
Sportübung	Compound
Augenblick	Compound
Nase	Unmotivated
Gasse	Unmotivated
Erzbischofel	Compound
Tor	Phrase
Zimmer	Unmotivated
Fehler	Derivative
Herbst - s	Phrase
Pumphose	Unmotivated
Rohrstock	Compound
Spielgefährtin	Compound
Artikelchen werden	Phrase
n Nickerchen mögen	Phrase
Bücherbrett	Compound
Kängurupfote	Compound
Zeichen	Derivative
Entenbrüstchen	Derivative
Szene	Unmotivated
Werk	Unmotivated
Pupille	Unmotivated
holzzaun	Compound
Himmelschlüsselchen	Derivative
nützliches Gerät	Phrase
Blumenzwiebel	Compound
Chef	Unmotivated
Punkt war plötzlich dort Stück neben dem Mittelpunkt glühend	Phrase
Bettchen	Derivative
Kragen	Unmotivated
Wägelchen	Derivative
Junge -n	Phrase
Radieschen	Derivative
Pappe	Unmotivated
Maschine	Unmotivated
Neigungen	Derivative
Brettchen	Derivative
Knecht	Phrase
Libellen	Derivative
Körbchen	Derivative
Urlaub	Unmotivated
Silberrahmen eingefaßte Foto	Phrase
Totenglocke	Compound
Elfe	Unmotivated
Weg	Unmotivated
Vanille	Unmotivated
wir Fischkessel	Phrase
ist wie ein kleiner harter Flügel	Phrase
Stück	Unmotivated
Beinchen	Derivative
Marschall	Compound
Faser	Unmotivated
wilder Haufen	Phrase
Aluminium	Unmotivated
Samenkorn	Compound
Kreisel	Derivative
einen Kessel	Phrase
Teil	Unmotivated
junge Mann	Phrase
kleines Menschenknäuel	Phrase
mini-gewächshaus	Derivative
Platte	Unmotivated
Deckelfolie	Compound
Zufall	Unmotivated
Bündel	Unmotivated
Gartenanlage	Compound
überraschungskiste	Compound
Friedhof	Compound
Schlaganfall	Compound
Wesen	Unmotivated
Augenbraue	Compound
Stiefmütterchen	Derivative
Köder	Unmotivated
Plastikdinger	Compound
Paket	Unmotivated
Mutter	Unmotivated
Knieschlag	Compound
Fahrtverlauf	Compound
Krankschreibung	Compound
Fluggesellschaft	Compound
Punkt	Unmotivated
Goldfinger	Compound
Draht	Unmotivated
Marienblümchen	Derivative
Getue eines Fohlens	Phrase
Schnittpunkt	Compound
Bokkie	Unmotivated
Wattestäbchen	Derivative
Zweig	Unmotivated
Flasche	Unmotivated
Apfel	Unmotivated
Hündin	Unmotivated
vierschrötiger Mann	Phrase
kleine Höhle	Phrase
Veranstaltung	Derivative
Hündchen	Derivative
Schwimmer Angel gerichtet	Phrase
Kostüm	Unmotivated
-Interessenpolitik	Compound
Reißzwecken	Compound
Bücherbord aussieht	Phrase
Ente	Unmotivated
Brocken	Unmotivated
Langdon Minisender	Phrase
Bügel	Unmotivated
Stachelarmband	Compound
Scherbe	Unmotivated
Lappen	Phrase
Beet	Phrase
Schneiderin nur halb so alt wie er	Phrase
Tasse	Unmotivated
Boot	Unmotivated
Tante	Unmotivated
Zeichen Pudel	Phrase
So eine Fickfackerei	Phrase
Maschinengewehrschütze	Phrase
Kette	Unmotivated
Wurzel	Unmotivated
Zeiger	Derivative
Fahne	Unmotivated
Wort	Unmotivated
Kriege	Unmotivated
Wasserstoff	Compound
Membranophon	Unmotivated
Pfeife	Derivative
Mann	Unmotivated
Familie	Unmotivated
Leiter	Unmotivated
Fräulein	Derivative
Schuh	Unmotivated
Maulkorb	Compound
Schlinge	Unmotivated
Wein	Unmotivated
Staub	Unmotivated
von irgendeinem Freundchen	Phrase
Fleisch	Unmotivated
Flügelspitze	Compound
Großvater	Compound
Zettel	Unmotivated
Wüstenfuchs	Compound
orthopädietechnik	Compound
Mäntelchen	Derivative
Karte	Unmotivated
Wurst	Unmotivated
Schweinchen	Derivative
Überraschungstüte	Compound
Schubkarre	Compound
Aktentasche	Compound
Clique	Unmotivated
Vorhang seien	Phrase
Wäscheklammer	Compound
verdeckte Operation	Phrase
Hustenbonbon	Compound
Zucker	Unmotivated
Wange	Unmotivated
Rednerbühne	Compound
Großvater	Phrase
Kasten	Unmotivated
Bambi-Blick	Derivative
Weintraube	Compound
Teechen	Derivative
Schuh	Unmotivated
Fläschchen	Derivative
Steckdose	Compound
junge Frau	Phrase
knappe halbe Stunde	Phrase
Schwertlilie	Compound
Straßenprostituierte	Compound
Spalte	Derivative
Tasche	Unmotivated
Hitze	Unmotivated
Vater	Unmotivated
Kotelettsträng	Compound
Seiten insgeheim	Phrase
Strauch	Unmotivated
Treffen	Unmotivated
Ergebnisse	Unmotivated
Leiter	Unmotivated
Melonenhut	Compound
Urgroßvater	Compound
Sentenz	Unmotivated
Närrchen	Derivative
Weihnachtsbaum	Compound
Buch	Unmotivated
Neger sein	Phrase
Formel	Derivative
Memmen	Unmotivated
Hilfe	Unmotivated
schachtgräberanlage	Compound
Alte	Phrase
Peitsche	Phrase
Eiererzeugung	Compound
Lied	Unmotivated
Defizit	Derivative
Dörfchen	Derivative
weit voraus eine Gruppe bewaldeter	Phrase
Unterstand	Phrase
Häufchen	Derivative
Koffer	Unmotivated
Kleeblatt	Compound
Zopfband	Phrase
Platz	Unmotivated
Geliebten	Unmotivated
Zauberstab	Compound
Leine	Unmotivated
Haar	Phrase
Idyll	Phrase
Repräsentativprobe	Compound
Geschäft	Unmotivated
Plattform gab	Phrase
Samthandschuh	Compound
Gruppe Dorfhäusern genügend Deckung bot	Phrase
Spiegel	Unmotivated
Stutenfohlen	Compound
Täubchen	Derivative
Gruppe	Unmotivated
Anrufsammeltaxe	Compound
Winkel	Unmotivated
Artikel	Unmotivated
Floop-Fluffle-Mord	Compound
Pflanze	Unmotivated
Zapfen	Unmotivated
mein kleines Theater	Phrase
Motorräder	Compound
Magd	Unmotivated
schlafanzüge	Compound
Junge	Unmotivated
Ampulle	Unmotivated
Bäuchlein	Derivative
Weihnachtsbaum	Compound
Rosenknospe	Compound
Latte aufgestapelten Bauholz fehle	Phrase
Büchse	Unmotivated
Tapfere Schneiderlein	Phrase
Engelchen	Derivative
Rotkäppchen sagte Sofie kopfschüttelnd	Phrase
Ziege	Unmotivated
Göttergatte	Compound
Leichnam eines Sperlings	Phrase
zieht das reizende Näschen wieder	Phrase
Schaltuhr	Compound
Bauernblusen	Compound
Pension	Phrase
Zettel	Phrase
Gabel	Unmotivated
Hobel	Unmotivated
Törtchen	Derivative
Bläschen	Derivative
Feuer	Unmotivated
aus dem Tal eine Aschenstätte	Phrase
Zollstock	Compound
Zigarre anspitzten	Phrase
Eichhörnchen	Derivative
Scheibe	Unmotivated
Weinbrand	Compound
Ostschermaus	Compound
Konsolfräsmaschinen	Compound
Bläschen	Derivative
Schmusekater	Compound
spielplatz	Compound
Zigarillo	Phrase
Einsprengsel	Compound
Körnchen	Derivative
Windfahne	Compound
Bock	Phrase
Wäldchen	Derivative
Kaurimuschel	Compound
Prinzesschen	Derivative
Häubchen	Derivative
Handfesseln	Compound
Zimmer	Unmotivated
wo doch Unordnung	Phrase
Aktentasche	Compound
Zwiebelkeller	Compound
Verse	Unmotivated
Arme	Phrase
Haut	Unmotivated
Stöckchen	Derivative
wiewohl angehende Mönche	Phrase
Kokon	Unmotivated
Gläschen ein	Phrase
sondern eine Wurst	Phrase
Klemme	Derivative
vor dem Podium stehenblieb	Phrase
Rheumasalbe	Compound
Handbesen	Compound
Hubschrauber	Compound
Essensgutschein	Compound
Kammer	Unmotivated
Harlekin-Marienkäfer	Compound
Fußmatte	Compound
einen Pullover	Phrase
Hütte	Unmotivated
Gewicht	Unmotivated
Kabine	Unmotivated
Ärmste	Phrase
Weibchen	Derivative
Sorte munterer Zigeunerbengel	Phrase
Weckruf dienen	Phrase
ja nur eine ganz kleine Sünde	Phrase
Dienstag	Unmotivated
Salzfässchen	Derivative
Ur-Ur-Großmutter	Compound
Frischling	Derivative
Garnelenfang	Compound
Faktum	Unmotivated
Pärchen	Derivative
Scherz	Unmotivated
Spezialität	Derivative
Affäre	Unmotivated
Handchenvoll	Compound
Zuckerkind	Compound
Augenblick	Compound
eiserne Geländer	Phrase
Notarztwagen	Compound
Hefepilz	Compound
rundes Brot	Phrase
trug er ein Blaulicht	Phrase
Affäre	Unmotivated
Bahre	Unmotivated
Hausaufgabe	Compound
Textilien	Derivative
Rest	Unmotivated
Eselchen	Derivative
Zettel	Unmotivated
Flämmchen	Derivative
Zipfelchen	Derivative
Erbsen	Unmotivated
T-Shirt	Compound
Vater	Unmotivated
Silhouette	Derivative
Zeitschrift	Compound
Gewittersturm	Compound
Chilierzeugnissen	Compound
Hügelchen	Derivative
Habseligkeiten	Compound
Äffchen	Derivative
Häschen	Derivative
Täubchen	Derivative
Kiste	Phrase
nach jeder Operation anfallende	Phrase
Glas	Unmotivated
Frauchen	Derivative
Gesichtchen	Derivative
Luftpumpe	Compound
Fell	Phrase
Lockpfeifen	Compound
Grinsen	Unmotivated
Chip	Unmotivated
zersprungener Waschtisch	Phrase
Kisten Aufprallen geplatzt	Phrase
sein Schnäbelchen	Phrase
Mieder	Phrase
Zwerg	Unmotivated
Sternchen	Derivative
musikerinitiative	Compound
Ofentür die zugemauert wird	Phrase
Untertasse	Compound
Hotel	Unmotivated
Fischmehl	Compound
Platz	Unmotivated
Getreide	Unmotivated
Karte	Unmotivated
Laufstall	Compound
Science-Fiction-Kram	Compound
Wölkchen	Derivative
Sekundenbruchteil	Compound
Kanarienvogel	Compound
erdbeerpflanze	Compound
Kopfzeile	Compound
Maus	Unmotivated
jüngere Schwester	Phrase
Prösterchen	Derivative
Ablagekorb	Compound
Sicherheitsmaßnahmen sind gründlich	Phrase
Kasten	Unmotivated
Kommode	Phrase
Klatschmaul	Compound
Wohnung	Derivative
Abendbrot	Compound
Röschen	Derivative
Plastikbeutel hoch	Phrase
Schnäuzchen	Derivative
Triebfeder	Compound
kleine Landschaft	Phrase
gleich einem magren Ährlein	Phrase
Typ	Unmotivated
Goldmäulchen	Derivative
Kerze	Unmotivated
Schriftgießen	Compound
Blumenkette	Compound
Scheibe	Phrase
geburtstagssause	Compound
Lotion	Unmotivated
Auto	Unmotivated
Fleckchen	Derivative
Falte	Derivative
unterhaltungsserien	Compound
scheues Vögelchen	Phrase
Lämmchen	Derivative
Streich	Unmotivated
Buchstaben	Unmotivated
Stimme	Unmotivated
lautsprecherkabels	Compound
Scherz handelt	Phrase
Mäntelchen	Derivative
Aschenbecher	Phrase
Schrift	Unmotivated
Knochen	Derivative
Schnurrbart	Compound
Kohlenstoff	Compound
Druckkugelschreiber	Compound
Schwanz	Unmotivated
Glas	Unmotivated
Datenbeschriftung	Compound
junger Stier	Phrase
Träne	Unmotivated
Gebet	Unmotivated
lustige Geigen	Phrase
Topfdeckel	Compound
Kind	Unmotivated
Judenbengel	Compound
Broschüre	Compound
Backenzahn	Compound
Spalt	Unmotivated
Depression	Derivative
Schritt	Unmotivated
Boot	Unmotivated
Zahnbürste	Compound
Hydro-Pistole	Compound
schmetterlingsstrauch	Compound
Kaninchen	Derivative
Lehne schleifte	Phrase
Kanne	Unmotivated
Schlauch	Unmotivated
Liebesdienerin	Compound
eckige Klammer	Phrase
Häschen	Derivative
Haus	Unmotivated
Hand	Unmotivated
Diele genannt	Phrase
Sonne	Unmotivated
brauereigaststätte	Compound
freewareprogramm	Compound
rechteckiger Blumenkasten entlanglief	Phrase
Kaffeelöffel	Compound
Zigarette	Unmotivated
Werkzeug zusammenzupacken	Phrase
Wölkchen	Derivative
Tasse	Unmotivated
Stück Kesselkuchen	Phrase
Hund	Unmotivated
kokette Kurve	Phrase
Drehleier	Compound
Mausefalle	Compound
Schätzchen	Derivative
Kühlschrank	Compound
Kabeldurchführung	Compound
Eichhörnchen	Derivative
Kätzchen	Derivative
Licht	Unmotivated
Buntstift	Compound
Schnur	Unmotivated
Nadel	Phrase
Priester	Unmotivated
Käfer	Unmotivated
Blüte	Unmotivated
Gettofaust	Compound
Tisch	Unmotivated
Platz	Unmotivated
kleinen Witzchen sein	Phrase
Summe	Unmotivated
Herz	Unmotivated
Kassette	Unmotivated
Silicium	Unmotivated
Marionette	Derivative
Gipfel	Unmotivated
Eisvogel	Compound
Donut	Unmotivated
Stufe	Phrase
Pavillon	Derivative
hätte einen Stein mitnehmen sollen	Phrase
Trinkröhrchen	Derivative
Granten	Unmotivated
Gartennelke	Compound
Wohnung	Derivative
Blutzelle	Compound
kleiner See	Phrase
Pause	Unmotivated
Kaffee	Unmotivated
Ehemännchen	Derivative
Tülle	Unmotivated
Mensch	Unmotivated
seinen sämtlichen Zweigen wurden Laternen aufgehängt	Phrase
Pfad	Unmotivated
Hinterleib	Compound
sich jeder junge Kuh	Phrase
Grinsen	Unmotivated
Hopfenzapfen	Compound
Turteltaube	Compound
Wort	Unmotivated
rechte Gans	Phrase
Brücke	Unmotivated
Hausfrau	Compound
Bündel	Unmotivated
Mikroorganismen	Compound
Spross	Unmotivated
Flüsschen	Derivative
Stuhl	Unmotivated
Geschenk	Derivative
Strich	Unmotivated
Schleife	Unmotivated
Laden	Unmotivated
lutschte an dem Hühnerbein	Phrase
nächsten Tag	Phrase
Mensch	Unmotivated
Schnitte	Unmotivated
Kümmelfrücht	Compound
Bruder	Unmotivated
Fregatte	Compound
Onkel	Unmotivated
Pfanne	Unmotivated
war das Fähnchen	Phrase
Blauhäher	Compound
lateinisches Alphabet	Phrase
Pfadfinder	Compound
Bank	Unmotivated
kleine Kirsche	Phrase
Toilette	Derivative
strebsamer Schüler er	Phrase
Zigeunerinnen	Compound
Programm	Unmotivated
Spötter	Derivative
Karyopse	Unmotivated
Pfingstrose	Compound
Urgroßvater	Compound
Dynamik	Derivative
Junge	Unmotivated
diese Spielzeugmaschine	Phrase
Eigenheit	Derivative
Teufelfreund	Compound
Kiste	Unmotivated
Karte	Unmotivated
Pikkolo	Phrase
Mädchen	Derivative
Nebennierenrind	Compound
Spaß	Unmotivated
Tabak	Unmotivated
einen Schrein	Phrase
Riesenpickel	Compound
Flugasche	Phrase
Stündchen	Derivative
Korb	Unmotivated
Pizzabrötchen	Derivative
Frau	Unmotivated
Schlößchen	Derivative
Ticket	Derivative
Fröschchen	Derivative
Mädchen	Derivative
Sprühregen	Compound
Kinderwagen	Compound
Tänzchen	Derivative
Hürchen	Derivative
Pockenimpfung aufwies	Phrase
Hälfte	Unmotivated
Kleiderschrank	Compound
reinliche Jüngling	Phrase
Fasanenbrust mit geben	Phrase
Gesicht	Unmotivated
Tröpfchen	Derivative
Oberwelle	Compound
Dachshund	Compound
gedenkplatz	Compound
Städtchen	Derivative
Netz	Unmotivated
Tasse	Unmotivated
