NaZi-Frau	Compound
Soldat	Derivative
Streithahn	Compound
Geberin	Derivative
Terroristin	Derivative
Mandolinistin	Derivative
Wahrsagerin	Derivative
Politikerin	Derivative
Aktivistin	Derivative
ministerpräsidentin	Derivative
Astronautin	Derivative
Bergsteiger	Unmarked
zeitungsreporterin	Derivative
Blondine	Derivative
Mädchen	Unmotivated
von Lehrmädchen neben	Phrase
Scharfschützengewehr	Compound
Schatzkammer	Unmarked
Paßinhaberin	Derivative
Gevatterin	Derivative
Reinemachefrau	Compound
Garderobier	Unmarked
Notarin	Derivative
Idiotin	Derivative
Jagd	Unmotivated
Cyclonudist	Unmarked
Offizier	Unmarked
Ehebrecherin	Derivative
Mandantin	Derivative
Arbeitnehmerinnen	Compound
Mikrocomputer	Unmarked
Röhre	Unmotivated
Köchin	Derivative
Sheriff	Unmotivated
Hutmacher	Unmarked
Spione	Unmotivated
Inspektor	Unmarked
Priesterin	Derivative
Hutmacher	Unmarked
Sanitäterin	Derivative
Programmierer	Unmarked
Geograph	Unmotivated
Akkordeonist	Unmarked
Schatzkammer	Unmarked
selber Flichtling	Phrase
Vertreterin	Derivative
Redakteurin	Derivative
Revuetänzerin	Derivative
Pianistin	Derivative
Golferin	Derivative
Tierverhalten	Compound
Cheerleaderin	Derivative
Abgeordnete	Unmotivated
Angehörige	Compound
Verkäuferin	Derivative
Horizont	Unmotivated
Äbtissin	Derivative
Bioklimatologe	Unmarked
Anführerin	Derivative
Elektriker	Unmarked
straßenbahnfahrerin	Derivative
Ministerin	Derivative
Verteiler	Unmarked
Gastroenterologe	Unmarked
Vizepräsidentin der	Phrase
Administrator	Unmarked
Barfrau	Compound
Revierbeamtin	Derivative
Kojotin	Derivative
Satansbrat	Compound
Therapeutin	Derivative
Heilige	Phrase
Snob	Unmotivated
amtierende Präsidentin	Phrase
Indianerin	Derivative
Patriotin	Derivative
Entdecker	Unmarked
Flamme	Unmotivated
Motorrad	Compound
Eröffnung	Unmotivated
PR-Beraterin	Compound
Benutzer	Unmarked
Kamerad	Unmotivated
Muslimin	Derivative
Drummerin	Derivative
Verbrecher	Unmarked
Schützin	Derivative
Mitbürger	Unmarked
Einser-Schülerin	Compound
Beifahrerin	Derivative
Bildhauerin	Derivative
Praktikantin	Derivative
Geschäftsfrau	Compound
Aristokratin	Derivative
Stripperin	Derivative
Klarinettist	Unmarked
Darstellerin	Derivative
Lexikograph	Unmotivated
Altersgenossin	Derivative
Erfinder	Unmarked
Platzanweiserin	Derivative
Baukasten	Compound
Neubauwohnung lebt	Phrase
Sekretärin	Derivative
Anästhesistin	Derivative
Isolierrohr	Compound
rehäugige Brünette	Phrase
Telegrafenfräulein	Derivative
Mikrobiologe	Unmarked
Vierzigerin	Derivative
Kosmetikerin	Derivative
Koordinatorin	Derivative
Mentorin	Derivative
Hersteller	Unmarked
Negerin	Derivative
Auktionator	Unmarked
lang eine Bettlerin	Phrase
Fotografin	Derivative
Parasit	Unmarked
Biber	Unmarked
Partnerin	Derivative
Verführerin	Derivative
Oligopolistin	Derivative
Chemiewerk	Compound
Ex-Frau	Derivative
Hochschülerin	Derivative
Physikerin eine Gelehrte	Phrase
Physiognom	Unmotivated
Konsul	Unmotivated
Kämpfer	Unmarked
Zuhörerin	Derivative
Haushälterin	Derivative
Bibliothekarin	Derivative
Pflegekraft	Compound
museumsmitarbeiterin	Derivative
Besitzerin	Derivative
Malerin	Derivative
Organisatorin	Derivative
Tontechnikerin	Derivative
Masseurin	Derivative
Kinderärztin	Derivative
Botschafterin	Derivative
Aromatherapeutin	Derivative
Klientel	Derivative
Mündel	Unmotivated
Neurologe	Unmarked
Encoder	Unmarked
Zofe	Phrase
Problem	Unmotivated
Schnaps	Phrase
Ein unersättliches Teufelchen unsere Valentina	Phrase
Bäckerin	Derivative
Oberschwester	Unmarked
servicemitarbeiterin	Derivative
Eine die schon mal Champion	Phrase
Spielerin	Derivative
Kundin	Derivative
Geschäftsfrau	Compound
Schöpfer	Unmarked
Weibchen	Derivative
Journalistin	Derivative
Sängerin	Derivative
Draufgängerin	Derivative
Vormund	Compound
Pfauenhenne	Compound
Zwergin	Derivative
Kardiologe	Unmarked
Zollhaus	Compound
Präsidentin	Derivative
Sekretärin	Derivative
Entführerin	Derivative
Musikerin	Derivative
Technologe	Unmarked
Brautwerber	Unmarked
Mitglied der	Phrase
Utopist	Unmarked
Pastellstift	Compound
Aktentasche	Compound
Patientin	Derivative
Geier	Unmarked
Unterhändler bei	Phrase
Tourist	Unmarked
Flugbegleiterin	Derivative
Geigerin	Derivative
Landstreicher	Unmarked
bratscherin	Derivative
Weissagerin	Derivative
Präfekt	Derivative
Gerichtsmedizinerin	Derivative
Musikerinnenblick gestülpt	Phrase
Pfadfinderin	Derivative
Tierarzt	Compound
Taube	Unmotivated
Herrscherin	Derivative
Ornithologe	Unmarked
meditationslehrerin	Derivative
Schlittschuhläuferin	Derivative
Konkurrentin	Derivative
Vorreiterin	Derivative
Physiotherapeutin	Derivative
Theologe	Unmarked
Physiologe	Unmarked
Hydrobiologe	Unmarked
Epidemiologe	Unmarked
straßenbahnfahrerin	Derivative
halbwüchsigen Mulattin hilflosem Aussehen	Phrase
Porträtist	Unmarked
Gladiator	Unmarked
Liebling	Derivative
Soldat	Derivative
Mitarbeiter	Unmarked
Nachbarin	Derivative
Rivalin lustig	Phrase
Käse-Piroge	Compound
Goldgräberin	Derivative
Mörderin	Derivative
Kamel	Unmotivated
Bezirksstaatsanwältin	Derivative
Dichterin	Derivative
Psychophantin	Derivative
Mitschülerin	Derivative
Leserin	Derivative
grundbesitzerin	Derivative
Partnerin	Derivative
Tischler	Unmarked
Schneiderin	Derivative
Einwohnerin	Derivative
Erzeugerin	Derivative
Anarchistin	Derivative
Kapitänin	Derivative
Collegestudentin	Derivative
Supermodel	Derivative
Rektor	Unmarked
undeutlich sichtbaren Gesäß meiner Bettgenossin zuzuwenden	Phrase
Junkie	Derivative
Rundwürmer	Unmarked
Pirat	Unmotivated
Kartograph	Unmotivated
Artillerie	Unmotivated
Texterin	Derivative
Investor	Unmarked
Edelfrau	Compound
begeisterte Anhängerin	Phrase
Gesandte Frauenrechte Wirklichkeit wird	Phrase
Direktor	Unmarked
Zenist	Unmarked
Amateurin	Derivative
Arbeitgeberin	Derivative
Planer	Unmarked
Konditorin	Derivative
Teenager	Unmarked
Geburtstagskind	Compound
Paläograph	Unmotivated
Stenotypistin	Derivative
Prüfung	Derivative
Philosophin	Derivative
Kristallpulver	Unmarked
Klägerin	Derivative
Highschool-Mädchen	Compound
Parodist	Unmarked
motorradfahrerin	Derivative
Kadettenanstalt	Compound
Sünderin	Derivative
Ehebrecherin	Derivative
Taube	Unmotivated
Adapter	Unmarked
Seeigel	Compound
Babysitter	Unmarked
Sozialistin	Derivative
Archivar	Derivative
Demonstrator	Unmarked
Vorgängerin	Derivative
Fliesen	Unmotivated
Ausländerin	Derivative
Touristin	Derivative
Jägerinnen	Unmotivated
Hochschullehrer	Unmarked
Kranke	Unmotivated
Ethikerin	Derivative
Namensvetter	Unmarked
Telefonistin	Derivative
Hirtin	Derivative
vor dieser Mittlerin wird	Phrase
Parapsychologe	Unmarked
gut erhaltenen Dreißigerin	Phrase
Puritanerin	Derivative
Vitalist	Unmarked
Modell	Unmotivated
Bewährungshelferin	Derivative
Dolmetscherin	Derivative
sie Nummer	Phrase
Diebin	Derivative
Karden	Unmotivated
Premierministerin	Derivative
Soziologe	Unmarked
Leichtathlet	Compound
Hexe	Derivative
Pförtner	Unmarked
Nachkommen Evas wahrgenommen werden	Phrase
Schubkasten	Compound
Reiterstellung	Compound
Marktfrau	Compound
Schuldnerin	Derivative
Zauberin	Derivative
Befreier	Unmarked
Maskenbildnerin	Derivative
Sexpartner	Unmarked
Diagnose	Derivative
Greisin	Derivative
Illustratorin	Derivative
Sportlehrer	Unmarked
Fahndung	Derivative
Prinzessin	Derivative
Demograph	Unmotivated
Bankerin	Derivative
Prediger	Unmarked
Blumenmädchen	Compound
Mitarbeiterin	Derivative
Tropf	Unmotivated
Chefin	Derivative
Sponsoring	Derivative
Kinderhüter	Unmarked
Bäuerin	Derivative
Hexe	Derivative
Privatdozentin	Derivative
Kamerafrau	Compound
Jüdin	Derivative
Landvermesser	Unmarked
Sprecherin	Derivative
Masochistin	Derivative
Krankenschwester	Unmarked
Täublinge	Compound
Animator	Unmarked
Lehrerin	Derivative
Rapper	Unmarked
Politologe	Unmarked
Vorführdame	Compound
Kellnerin	Derivative
Archäologin	Derivative
Erzieherin	Derivative
Gastgeberin	Derivative
Gärtnerin	Derivative
Bäuerin	Derivative
Vertreterin	Derivative
Aggressor	Unmarked
Lobbyist	Unmarked
Spender	Unmarked
Ente	Unmotivated
Schiläufer	Unmarked
Schwimmerin	Derivative
Frauenärztin	Derivative
Pilger	Unmarked
artikelerstellerin	Derivative
Gräfin	Derivative
Worten von Senatorin	Phrase
Magnat	Unmotivated
Linguist	Unmarked
Personalvermittler	Unmarked
Jägerin	Derivative
Joggerin	Derivative
Waffe	Unmotivated
Pflegetochter	Unmarked
Bärenmutter	Unmarked
Gründerin	Derivative
Gouverneurin	Derivative
Frisöse	Compound
scharfe Stück hier	Phrase
Spezialistin	Derivative
Wrestlerin	Derivative
doppelolympiasiegerin	Derivative
Polizistin verhört wurde	Phrase
Beobachter	Unmarked
Trainer	Unmarked
Wissenschaftlerin	Derivative
Saxophonist	Unmarked
Dermatologe	Unmarked
Kollegin	Derivative
Cousine	Phrase
Unglückliche frißt	Phrase
physiklehrerin	Derivative
Verlobte	Phrase
Zwergtaucher	Unmarked
Drache	Unmotivated
Jungfrau	Compound
Reporterin	Derivative
Koeffizient	Unmarked
Trainerin	Derivative
Evangelist	Unmarked
Chefin	Derivative
Traktor	Unmarked
Privatdetektivin	Derivative
folksängerin	Derivative
Essayist	Unmarked
Schlittschuhläuferin	Derivative
Stellvertreterin	Derivative
Virologe	Unmarked
Füllung	Derivative
Bergsteiger	Unmarked
Polizistin	Derivative
Handpfleger	Unmarked
Drehbuchautorin	Derivative
Spionage	Derivative
Taucher	Unmarked
Fan	Unmotivated
Psychoanalytikerin	Derivative
gnädige Frau	Phrase
Verräterin	Derivative
Madrigalist	Unmarked
Profi-Frauen-Volleyballteam	Compound
Doppelgängerin	Derivative
Terminologe	Unmarked
Elektroingenieur	Compound
wieder Blitztelegramm gebracht hatte	Phrase
Humorist	Unmarked
Designerin	Derivative
Philosophin	Derivative
Präsident	Unmarked
Meisterwerkstatt	Compound
Finalistin	Derivative
Schwäherin	Derivative
Stieftochter	Unmarked
Hochzeit	Unmarked
Dienerin	Derivative
Regentin	Derivative
Schulmädchen	Compound
Bürgermeisterin	Derivative
Baronin	Derivative
Agentin	Derivative
Untersekretärin des	Phrase
Endokrinologe	Unmarked
Künstlerin	Derivative
Beichtvater	Unmarked
Produzentin	Derivative
Herrin	Derivative
Einwanderer	Unmarked
anteilseignerin	Derivative
Komponistin	Derivative
Minchin-Drache	Compound
Geologin	Derivative
Vorwahl	Compound
Praktikantin	Derivative
Hirschkuh	Compound
Prostituierte	Unmotivated
gemeindevertreterin	Derivative
Logograph	Unmotivated
Hämatologe	Unmarked
Gewinnerin	Derivative
Physiotherapeut	Compound
musikdirektorin	Derivative
Betrügerin	Derivative
Jungverheiratete	Compound
Sänger	Unmarked
Linkshänderin	Derivative
Ingenieurin	Derivative
Putzfrau	Compound
Superheldin	Derivative
Nachfolgerin von	Phrase
Gerichtsreporterin	Derivative
Lautenistin	Derivative
Kubist	Unmarked
Meeresspiegel dahingleitenden Muschel Teilnehmerin des Wettkampfes	Phrase
Minister	Unmarked
Sirene	Unmotivated
Commander	Unmarked
Anwältin	Derivative
Chefköchin	Derivative
Vertrauten	Unmotivated
Genosse	Unmotivated
Vokalistin	Derivative
Zimmermädchen	Compound
beachvolleyballspielerin	Derivative
Feuerwehrmann	Unmarked
Moderatorin	Derivative
Kanzlerin	Derivative
Psychiatrie	Unmotivated
Motorradfahrer	Unmarked
Medizinstudentin	Derivative
Heilerin	Derivative
Illusionist	Unmarked
Mieterin	Derivative
Teamkollegin	Derivative
Richterin	Derivative
Novotomist	Unmarked
Musikwissenschaftler	Unmarked
Kriminaltechnikerin	Derivative
Meine Göttergattin ist seit neuestem	Phrase
Gerontologe	Unmarked
Schülerin	Derivative
Europäischen Gemeinschaften	Phrase
Kandidatin	Derivative
Psychologe	Unmarked
- Bodenbearbeitung betreibt	Phrase
Hüterin	Derivative
Strafgefangene	Phrase
Choreografin	Derivative
Hauptfigur	Compound
Zusatzscheiben	Compound
Propagandist	Unmarked
Tramper	Unmarked
Zahnärztin	Derivative
Bibliograph	Unmotivated
Reiterin	Derivative
reiseführerin	Derivative
Feministin	Derivative
Ihrer Namenspatronin	Phrase
Goldkörnchen unglücklichen	Phrase
Pianistin	Derivative
Praktikantin	Derivative
Zeugin	Derivative
als Friedensstifterin fungieren wollte	Phrase
Anwältin	Derivative
Redakteurin	Derivative
Baronesse	Phrase
Direktorin	Derivative
Gastgeberin	Derivative
Privatlehrerin	Derivative
Telefonistin	Derivative
Wachstube	Compound
Analytiker	Unmarked
Ziehmutter	Unmarked
Freundin	Derivative
Tabakhändlerin	Derivative
Krankenbetreuerin bei der Bauleitung	Phrase
kunstwissenschaftlerin	Derivative
Samenkapsel	Compound
Sportler	Unmarked
Anwalt	Unmotivated
Chirurgen	Derivative
Schmetterling	Compound
Schönheit	Unmarked
Tennisspieler	Unmarked
Mündel	Unmotivated
Ordensschwester	Unmarked
Sklavin	Derivative
Weibersolo junges Mädchen	Phrase
Blättchen	Derivative
Rotschopf	Compound
Mairübe	Unmotivated
Ärztin	Derivative
Schimpanse	Unmotivated
Gesetzgeber	Unmarked
Walbiologin	Derivative
Ehepartnerin	Derivative
Engelwurz	Compound
Drogendealerin	Derivative
Lügnerin	Derivative
Lieutenant	Unmarked
Psychotherapeutin	Derivative
Hellseherin	Derivative
Informantin	Derivative
Hermaphrodit	Unmarked
Freundin	Derivative
Dekorateur	Derivative
Vizepräsidentin	Derivative
Gefangene	Derivative
Kupplerin	Derivative
Märtyrerin	Derivative
Eidechse	Compound
Chefredakteurin	Derivative
Stenotypistin	Derivative
Dekan	Unmotivated
Schachbrett	Compound
Politiker-Familie	Compound
Beraterin	Derivative
Arbeitsanzug	Compound
Hüterin	Derivative
Bombenlegerin	Derivative
Sprechstundenhilfe	Compound
Züchter	Unmarked
Biber	Unmarked
Unternehmerin	Derivative
Mitarbeiterin	Derivative
Recht	Unmotivated
Bleistift	Compound
botschafterin	Derivative
Studienanfängerin	Derivative
Verwalterin	Derivative
Taxameter weit vor Ende Fahrt	Phrase
Autofahrer	Unmarked
Anwältin	Derivative
chorfrau	Compound
Chartist	Unmarked
Kaiserin	Derivative
Oboistin	Derivative
Haupterbin die Geschäfte führen	Phrase
Spanner	Unmarked
Assistentin	Derivative
Diktator	Unmarked
Zertifizierer	Unmarked
Übersetzerin	Derivative
Besucher	Unmarked
vergleichen mit den senilen alten Radcliffe-Alumnen	Phrase
Arbeiterinnen	Compound
Übergrös	Compound
Trägerin	Derivative
Architekt	Unmotivated
Bloggerin	Derivative
Existentialistin	Derivative
Junkie	Derivative
Ärztin	Derivative
Alchimist	Unmarked
Assistenzärztin	Derivative
Sammlerin	Derivative
Nenner	Unmarked
Schnur	Unmotivated
fraktionschefin	Derivative
Kommentator	Unmarked
Immunologe	Unmarked
Flittchen	Derivative
Bäuerin	Derivative
Wachfrau	Compound
Violinist	Unmarked
Verfasserin	Derivative
Tagesprophet	Compound
Expertin	Derivative
Kommissarin	Derivative
Fußballerin	Derivative
Cellistin	Derivative
Vorturnerin ihre	Phrase
