unanazi	Derivative
soldado	Derivative
pendenciero	Derivative
editora	Derivative
terrorista	Derivative
mandolinista	Derivative
profeta	Derivative
política	Derivative
activista	Derivative
vicegobernadora	Derivative
astronauta	Derivative
trepador	Derivative
fotógrafa	Derivative
rubia sin embargo	Phrase
niña	Unmotivated
era entonces aprendiza	Phrase
rifle	Unmotivated
tesoro	Unmotivated
ganadora premio	Phrase
nieta	Unmotivated
asistente doméstica	Phrase
guardarropa	Derivative
notario	Derivative
idiota	Unmotivated
persecución	Derivative
ciclonudista	Derivative
agente	Unmotivated
adúltera	Derivative
cliente	Derivative
agente	Unmotivated
microordenador	Derivative
tubo	Unmotivated
cocinero	Derivative
comisario	Derivative
modista	Derivative
espías	Unmotivated
inspector	Derivative
sacerdotisa	Derivative
modista	Derivative
ambulanciera	Derivative
programador	Derivative
geógrafo	Derivative
acordeonista	Derivative
tesoro	Unmotivated
refugiada birmana	Phrase
representante	Derivative
correctora	Derivative
corista	Derivative
pianista	Derivative
golfista	Derivative
periodista	Derivative
animador	Derivative
diputada	Derivative
su empleo esas circunstancias dicha nacional turca	Phrase
vendedor	Derivative
horizonte	Derivative
abadesa	Derivative
bioclimatólogo	Derivative
líder	Unmotivated
electricista	Derivative
peatona	Derivative
ministra	Derivative
distribuidor	Derivative
gastroenterólogo	Derivative
vicepresidenta de	Phrase
administrador	Derivative
camarera	Derivative
guardiana	Derivative
zorra	Unmotivated
diablesa	Derivative
terapeuta	Derivative
santa mujer	Phrase
snob	Unmotivated
presidenta	Derivative
india	Unmotivated
patriota	Derivative
descubridor	Derivative
amante	Unmotivated
moto	Unmotivated
apertura	Derivative
publicista	Derivative
usuario	Derivative
camarada	Derivative
musulmana llorando	Phrase
baterista	Derivative
rob贸	Unmotivated
sus compañeras cazadoras	Phrase
conciudadano	Derivative
estudiante	Derivative
pasajera	Derivative
escultora	Derivative
asistente	Derivative
mujer de negocios	Phrase
aristócrata	Derivative
striptease	Derivative
clarinetista	Derivative
actriz	Unmotivated
lexicógrafo	Derivative
figura	Unmotivated
inventor	Derivative
sala acomodadora	Phrase
mecano	Unmotivated
burguesa muy mimada	Phrase
secretario	Derivative
anestesista	Derivative
conducto de agua	Phrase
morena mofletuda y	Phrase
telegrafista	Derivative
microbiólogo	Derivative
cuarentona	Derivative
esteticista	Derivative
coordinadora	Derivative
mentora	Derivative
fabricante	Derivative
negra	Unmotivated
subastador	Derivative
pordiosera	Derivative
fotógrafa	Derivative
parásito	Derivative
castor	Unmotivated
pareja	Unmotivated
tentación	Derivative
oligopolista	Derivative
quimico	Derivative
ex-mujer	Derivative
estudiante	Derivative
experta docente preparada	Phrase
fisiognoma	Derivative
cónsul	Unmotivated
guerrera	Derivative
oyente	Unmotivated
ama de casa	Phrase
bibliotecaria	Derivative
cuidadora	Derivative
restauradora	Derivative
dueña	Unmotivated
pintora	Derivative
coordinadora	Derivative
técnica sonido	Phrase
masajista	Derivative
pediatra	Derivative
embajadora	Derivative
aromaterapista	Derivative
clientela	Derivative
pupila	Unmotivated
neurólogo	Derivative
codificador	Derivative
doncella	Derivative
problema	Derivative
caña	Unmotivated
demonio	Derivative
pastelera	Derivative
abadesa	Derivative
digitadora	Derivative
campeona	Derivative
jugadora	Derivative
cliente	Derivative
mujer de negocios	Phrase
creador	Derivative
hembra	Unmotivated
periodista	Derivative
cantante	Derivative
tipa	Unmotivated
tutora	Unmotivated
pavo	Unmotivated
enanas	Unmotivated
cardiólogo	Derivative
aduanas	Derivative
presidente	Derivative
secretaria	Derivative
secuestradora	Derivative
cantante	Derivative
tecnólogo	Derivative
casamentera	Derivative
miembro de	Phrase
utopista	Derivative
crayón	Unmotivated
maletín	Derivative
paciente	Derivative
buitre	Unmotivated
negociador	Derivative
turista	Derivative
azafata	Derivative
violinista	Derivative
buscona	Derivative
gaitera	Derivative
profeta	Derivative
prefecto	Derivative
patóloga	Derivative
músico	Unmotivated
explorador	Derivative
veterinario	Derivative
paloma	Unmotivated
soberana había estrenar	Phrase
ornitólogo	Derivative
arteterapeuta	Derivative
patinadora	Derivative
competencia	Derivative
pionera	Derivative
fisioterapeuta	Derivative
teólogo	Derivative
fisiólogo	Derivative
hidrobiólogo	Derivative
epidemiólogo	Derivative
choferesa	Derivative
mulata	Unmotivated
retratista	Derivative
gladiador	Derivative
favorita	Derivative
soldado	Derivative
subjefe	Derivative
vecina asiento	Phrase
rival	Unmotivated
pierogie	Derivative
cazafortuna	Derivative
asesina	Derivative
camello	Derivative
distrino	Derivative
poeta	Unmotivated
sociópata	Derivative
estudiante	Derivative
lector	Unmotivated
posesora	Derivative
pareja	Unmotivated
carpintero	Derivative
costurera	Derivative
residente	Derivative
creador	Derivative
ellarquistas	Derivative
han nombrado capitana	Phrase
estudiante	Derivative
supermodelo	Derivative
rector	Unmotivated
téngase presente compañera lecho	Phrase
drogadicto	Derivative
oxiuros	Derivative
pirata	Unmotivated
cartógrafo	Derivative
artillería	Derivative
redactora	Derivative
inversor	Derivative
violencia carnal una ricadueña	Phrase
ellenjamesianas	Derivative
embajadora	Derivative
director	Derivative
zenista	Derivative
aficionado	Derivative
empleadora	Derivative
planificador	Derivative
repostería	Derivative
agria-loca	Compound
cumpleañera	Derivative
paleógrafo	Derivative
taquígrafa	Derivative
examen	Unmotivated
filósofa	Derivative
cristal	Derivative
demandante	Derivative
estudiante	Derivative
parodista	Derivative
motoquera	Derivative
escuela de cadete	Phrase
sequedad culpables	Phrase
adúltera	Derivative
paloma	Unmotivated
adaptador	Derivative
erizo marino	Phrase
hermana mayor	Phrase
adalid	Unmotivated
archivista	Derivative
demostrador	Derivative
predecesora	Derivative
loseta	Unmotivated
extranjera	Derivative
turista	Derivative
cazadora solitaria	Phrase
profesora	Derivative
enfermos	Derivative
antropóloga	Derivative
tocaya	Unmotivated
operadora	Derivative
pastora	Derivative
con mediadora	Phrase
parapsicólogo	Derivative
treinta años	Phrase
mojigata	Derivative
vitalista	Derivative
modelo	Unmotivated
comisaria	Derivative
intérprete	Derivative
preciosidad	Derivative
ladrona	Derivative
escobilla	Derivative
primera ministra	Phrase
sociólogo	Derivative
deportista	Derivative
bruja	Unmotivated
portera	Derivative
digna émula	Phrase
gaveta	Unmotivated
vaquera	Derivative
pescadera largarte	Phrase
deudora	Derivative
bruja	Unmotivated
libertador	Derivative
maquillaje	Derivative
persona enamorada	Phrase
diagnóstico	Derivative
mujer vieja	Phrase
ilustradora	Derivative
gimnasta	Derivative
búsqueda	Derivative
princesa	Derivative
demografía	Derivative
banquera	Derivative
predicador	Derivative
florista	Derivative
asistente social	Phrase
piquero	Derivative
jefa	Unmotivated
patrocinio	Derivative
niñera	Unmotivated
agricultora	Derivative
bruja	Unmotivated
doctor	Unmotivated
camarógrafa	Derivative
judía salida	Phrase
topógrafo	Derivative
presentadora	Derivative
maniac	Unmotivated
sor	Unmotivated
rúsula	Unmotivated
animador	Derivative
profesora	Derivative
rapero	Unmotivated
politólogo	Derivative
modelo	Unmotivated
mesera	Unmotivated
arqueóloga	Derivative
institutriz	Derivative
anfitriona	Derivative
jardinería	Derivative
campesina	Derivative
representante de	Phrase
agresor	Derivative
cabildero	Derivative
donante	Derivative
pato	Unmotivated
esquiador	Derivative
nadadora	Derivative
ginecóloga	Derivative
peregrino	Derivative
bloguera	Derivative
condesa	Derivative
senadora	Derivative
magnate	Derivative
lingüista	Derivative
reclutador	Derivative
cazavampiro	Derivative
corredor	Derivative
fierro así tiene nada	Phrase
pupila	Unmotivated
orión la osa mayor la	Phrase
fundador	Derivative
gobernador	Derivative
peluquera	Derivative
amiga	Unmotivated
especialista	Derivative
mexicana-americano	Compound
tricampeona	Derivative
policía tomó declaración	Phrase
observador	Derivative
entrenadora	Compound
investigadora sentir	Phrase
saxofonista	Derivative
dermatólogo	Derivative
colega	Unmotivated
prima hermana	Phrase
puñetera	Derivative
profesora	Derivative
novia	Unmotivated
somormujo	Derivative
dragón	Unmotivated
muñeca	Unmotivated
periodista	Derivative
coeficiente	Derivative
entrenadora	Compound
evangelista	Derivative
jefa	Unmotivated
tractor	Derivative
investigador	Derivative
cantautora	Derivative
ensayista	Derivative
patinador	Derivative
alquiler	Derivative
virólogo	Derivative
carne--	Compound
trepador	Derivative
policía femenino	Phrase
manicura	Derivative
escritora	Derivative
espionaje	Derivative
buzo	Unmotivated
fan	Unmotivated
psicoanalista	Derivative
señora	Unmotivated
traidora	Derivative
madrigalista	Derivative
voleibolista	Derivative
doppelganger	Derivative
terminólogo	Derivative
ingeniero eléctrico	Phrase
descolgado mujer	Phrase
humorista	Derivative
diseñadora	Derivative
filósofa	Derivative
presidente	Derivative
arsenal	Derivative
drag-queens	Compound
madre política	Phrase
hijastra	Derivative
boda	Unmotivated
sirvienta	Derivative
regente	Derivative
colegiala	Derivative
alcaldesa	Derivative
baronesa	Derivative
agente	Unmotivated
manos	Unmotivated
endocrinólogo	Derivative
artista	Derivative
confesor	Derivative
productora	Derivative
monarca	Derivative
inmigrantes	Derivative
postora	Derivative
compositora	Derivative
demonio	Derivative
geóloga	Derivative
área	Unmotivated
práctica	Derivative
corzo	Unmotivated
prostituta	Derivative
alcaldesa	Derivative
logografía	Derivative
hematólogo	Derivative
ganador	Derivative
fisioterapeuta	Derivative
actriz-cantante	Compound
impostora	Derivative
joven recién casada	Phrase
cantante	Derivative
derecha	Derivative
ingeniero	Derivative
asistente doméstica	Phrase
superheroína	Derivative
sustitución de	Phrase
taquígrafa	Derivative
mujer que toca el laúd	Phrase
cubista	Derivative
corredora	Derivative
ministro	Derivative
mujer fatal	Phrase
jefe	Unmotivated
abogada	Derivative
cocina	Unmotivated
persona confianza	Phrase
camarada	Derivative
cantor	Unmotivated
camarera	Derivative
exjugadora	Derivative
bombero	Derivative
presentadora	Derivative
canciller	Derivative
psiquiatría	Derivative
motociclista	Derivative
médica en cuestión	Phrase
curandera	Derivative
ilusionista	Derivative
inquilina las cajas	Phrase
compañero	Derivative
jueza	Unmotivated
novotomista	Derivative
musicólogo	Derivative
criminóloga	Derivative
bobalicona devota	Phrase
gerontólogo	Derivative
colegiala	Derivative
— parte coadyuvante	Phrase
candidato	Derivative
psicóloga	Derivative
agricultora	Derivative
guardiana	Derivative
persona condenada	Phrase
coreógrafa	Derivative
heroína	Derivative
bolo	Unmotivated
propagandista	Derivative
autoestopista	Derivative
dentista	Derivative
bibliógrafo	Derivative
amazona	Derivative
anfitriona	Derivative
es una feminista	Phrase
patrona	Derivative
pobre mujer	Phrase
pianista	Derivative
residente	Derivative
honor	Unmotivated
paloma	Unmotivated
giannini	Derivative
editora	Derivative
británica señora	Phrase
directora	Derivative
anfitrión	Derivative
tutor	Unmotivated
operadora	Derivative
prevención	Derivative
analista	Derivative
niñera	Unmotivated
amiga	Unmotivated
vendedora había hablado	Phrase
enfermera de campaña	Phrase
museógrafa	Derivative
mazo	Unmotivated
deportista	Derivative
abogado	Derivative
cirujanos	Derivative
mariposa	Derivative
hermosura	Derivative
tenista	Derivative
cargo	Unmotivated
monja	Unmotivated
esclava	Derivative
jovencita	Derivative
nota	Unmotivated
pelirroja	Derivative
nabo	Unmotivated
médico	Unmotivated
chimpancé	Derivative
legislador	Derivative
bióloga	Derivative
esposa	Unmotivated
yvariedad	Derivative
narcotraficante	Derivative
tan embustera	Phrase
paxton	Unmotivated
terapeuta	Derivative
vidente	Derivative
soplona	Derivative
hermaphrodit	Derivative
novia	Unmotivated
decorador	Derivative
vicepresidente	Derivative
prisionera	Derivative
alcahueta	Derivative
mártir	Unmotivated
lagarto	Derivative
editora	Derivative
mecanógrafa	Derivative
decano	Unmotivated
tablero de ajedrez	Phrase
diputada	Derivative
tutora	Unmotivated
overol	Unmotivated
guardiana de	Phrase
atacante	Derivative
enfermera instrumentista	Phrase
criador	Derivative
castor	Unmotivated
empresaria	Derivative
de colaboradora de	Phrase
derechazo	Derivative
lápiz	Unmotivated
embajadora	Derivative
estudiante	Derivative
cuidadora	Derivative
se permitiese pasajera	Phrase
conductora	Derivative
abogada	Derivative
ecónoma	Derivative
chartista	Derivative
emperatriz	Derivative
oboe	Unmotivated
heredera	Derivative
mirón	Unmotivated
subjefe	Derivative
dictador	Derivative
certificador	Derivative
intérprete	Derivative
visitador	Derivative
licenciada en	Phrase
obreras	Derivative
drunky-chunky	Compound
premio	Unmotivated
arquitecta	Derivative
bloguera	Derivative
existencialista que	Phrase
droga	Unmotivated
doctora	Derivative
alquimista	Derivative
residente	Derivative
coleccionista	Derivative
denominador	Derivative
cuñada	Unmotivated
diputada	Derivative
comentarista	Derivative
inmunólogo	Derivative
zorra	Unmotivated
campesina	Derivative
niñera	Unmotivated
violinista	Derivative
autora	Unmotivated
oracle	Unmotivated
experta	Derivative
comisaria	Derivative
futbolista	Derivative
violonchelista	Derivative
ladró instructora	Phrase
