vliegmaatschappij	Compound
affaire	Unmotivated
prieel	Unmotivated
ampul	Unmotivated
angels	Unmotivated
cherubijnen	Compound
autoo	Unmotivated
grootmoeder	Compound
pakket	Unmotivated
vluchtmiddel	Compound
rijzwepen	Compound
mens	Unmotivated
gekken	Derivative
shirt	Unmotivated
uitwerpselen	Compound
jeneverbessen	Compound
brood	Unmotivated
laars	Unmotivated
laars	Unmotivated
storm	Unmotivated
tepel	Unmotivated
chip	Unmotivated
chip	Unmotivated
doel	Unmotivated
neef	Unmotivated
broert	Unmotivated
perzik	Derivative
kind	Unmotivated
brochure	Derivative
veenbes	Compound
rietje	Derivative
bubbel	Unmotivated
trommelvlies	Compound
brood	Unmotivated
wekdienst	Compound
jas	Unmotivated
bolhoed	Compound
kruiden	Unmotivated
appartement	Derivative
omi	Unmotivated
boei	Unmotivated
buikje	Derivative
etiket	Unmotivated
weg	Unmotivated
hut	Unmotivated
diepvriezer	Compound
kind	Unmotivated
type	Unmotivated
brood	Unmotivated
ontharing	Derivative
persoon	Unmotivated
smaak	Unmotivated
meisje	Derivative
tijd	Unmotivated
tijd	Unmotivated
toverbonen	Compound
fout	Unmotivated
fout	Unmotivated
babyfoon	Compound
ui	Unmotivated
sigaret	Unmotivated
zigeunerin	Derivative
suikerwerk	Compound
snoep	Unmotivated
suiker	Unmotivated
katheter	Unmotivated
put	Unmotivated
wafer	Unmotivated
spats	Unmotivated
parapluu	Derivative
theater	Unmotivated
feestpakket	Compound
dokter	Unmotivated
kuil	Unmotivated
poppenhuis	Compound
cupcake	Derivative
cake	Derivative
verlof	Unmotivated
lieverds	Derivative
nagel	Unmotivated
ziel	Unmotivated
tuin	Unmotivated
koelkast-vrieskastcombinatie	Compound
dynamiek	Derivative
vrouw	Unmotivated
geschenk	Derivative
stuk	Unmotivated
kind	Unmotivated
meisje	Derivative
man	Unmotivated
grootvader	Compound
hoer	Unmotivated
kind	Unmotivated
glas	Unmotivated
reu	Unmotivated
viool	Unmotivated
stuk	Unmotivated
stift	Unmotivated
fles	Unmotivated
vlek	Unmotivated
vader	Unmotivated
freesmachine	Compound
vorm	Unmotivated
haarband	Compound
buis	Unmotivated
doek	Unmotivated
top	Unmotivated
aluminium	Unmotivated
kkien	Unmotivated
hopbel	Compound
liefdesnestje	Derivative
horloge	Unmotivated
horloge	Unmotivated
duif	Unmotivated
hallo	Unmotivated
huisvrouw	Compound
restaurant	Derivative
hotel	Unmotivated
poep	Unmotivated
uur	Unmotivated
chip	Unmotivated
tortelduif	Compound
kop	Derivative
kop	Derivative
kop	Derivative
stuk	Unmotivated
rozijn	Derivative
handjevol	Compound
erwt	Unmotivated
zwartbuikfluitenen	Compound
asterisk	Derivative
adder	Unmotivated
spijker	Unmotivated
kruidnagel	Compound
stok	Unmotivated
tomaat	Unmotivated
tong	Unmotivated
eenheid	Derivative
speldenkussen	Compound
lammetje	Derivative
kribbe	Unmotivated
teckel	Unmotivated
vijver	Unmotivated
hoop	Unmotivated
menu	Unmotivated
tezen	Unmotivated
paskamer	Compound
eend	Unmotivated
koffie	Unmotivated
slip	Unmotivated
maat	Unmotivated
steen	Unmotivated
kanarie	Unmotivated
zakdoek	Compound
bloed	Unmotivated
kapel	Unmotivated
zak	Unmotivated
roodkapje	Derivative
plaat	Unmotivated
tandenborstel	Compound
spaarpotten	Compound
eend	Unmotivated
koninginnengelei	Compound
heester	Unmotivated
stok	Unmotivated
hamer	Unmotivated
showparen	Compound
maas	Unmotivated
hoed	Unmotivated
kluwens	Derivative
sleutel	Unmotivated
manchetknoop	Compound
boek	Unmotivated
boek	Unmotivated
tapijt	Unmotivated
schat	Unmotivated
sprinkhanen	Compound
kraan	Unmotivated
keer	Unmotivated
brownie	Derivative
barbecuetent	Derivative
schoenpinnen	Compound
vingertoppen	Compound
theepot	Compound
hobby	Unmotivated
schep	Unmotivated
tiara	Unmotivated
parel	Unmotivated
kerk	Unmotivated
blok	Unmotivated
kubus	Unmotivated
pak	Unmotivated
pot	Unmotivated
deel	Unmotivated
ooghoek	Compound
borst	Unmotivated
valeriaan	Derivative
stuk	Unmotivated
kinderwagen	Compound
wortel	Unmotivated
nachthemd	Compound
mand	Unmotivated
cups	Unmotivated
poes	Unmotivated
verpakking	Derivative
landschappen	Derivative
hupsakee	Derivative
garnaal	Unmotivated
halskarbonade	Compound
school	Unmotivated
bloedcel	Compound
konijn	Derivative
konijn	Derivative
winkel	Unmotivated
schoonheid	Derivative
stapje	Derivative
gezicht	Derivative
bidsprinkhaan	Compound
marcinko	Unmotivated
koffer	Unmotivated
poes	Unmotivated
teef	Unmotivated
meisje	Derivative
gisten	Unmotivated
bloem	Unmotivated
bloem	Unmotivated
plant	Unmotivated
koffie	Unmotivated
silicium	Unmotivated
stoel	Unmotivated
kruis	Unmotivated
nagelrieem	Compound
fles	Unmotivated
winkel	Unmotivated
oorlel	Compound
nachtlam	Compound
kabel	Unmotivated
wezel	Unmotivated
bank	Unmotivated
lat	Unmotivated
schedel	Unmotivated
koelkast	Compound
karton	Unmotivated
lesbienne	Derivative
ticket	Unmotivated
folder	Derivative
lijn	Derivative
pumps	Unmotivated
schouderblad	Compound
rubberboot	Compound
vlok	Unmotivated
hinderlaag	Compound
kraag	Unmotivated
theelepel	Compound
viool	Unmotivated
hydropistool	Derivative
pink	Unmotivated
echtgenoot	Compound
kaart	Unmotivated
balsem	Unmotivated
vis	Unmotivated
moeder	Unmotivated
moedertje	Derivative
huisdier	Compound
huisdier	Compound
machine	Unmotivated
strik	Unmotivated
beer	Unmotivated
dag	Unmotivated
kind	Unmotivated
moment	Unmotivated
melk	Unmotivated
gehaktmool	Compound
gebed	Unmotivated
moment	Unmotivated
bot	Unmotivated
meel	Unmotivated
cerebellum	Unmotivated
diepvriezer	Compound
wortel	Unmotivated
beroerte	Unmotivated
regenwolk	Compound
koek	Unmotivated
mannen	Unmotivated
muis	Unmotivated
plaats	Unmotivated
bal	Unmotivated
plaats	Unmotivated
goudsbloem	Compound
rooster	Derivative
bijnierschor	Compound
visitekaar	Compound
touwtje	Derivative
brancard	Unmotivated
nieuws	Unmotivated
voet	Unmotivated
pelterijen	Unmotivated
zaak	Unmotivated
stortbak	Compound
kans	Unmotivated
stemming	Derivative
schets	Unmotivated
winkeltje	Derivative
kleding	Derivative
gezicht	Derivative
rook	Unmotivated
monturen	Unmotivated
afbeelding	Compound
beveiliging	Derivative
tierelantijn	Derivative
vuur	Unmotivated
box	Unmotivated
kantoor	Unmotivated
vak	Unmotivated
brief	Unmotivated
aap	Unmotivated
strop	Unmotivated
aop	Unmotivated
nummer	Unmotivated
eilandje	Derivative
schaap	Unmotivated
nootmuskaat	Compound
konijnenpoot	Compound
pop	Unmotivated
vrouw	Unmotivated
maat	Unmotivated
peper	Unmotivated
brief	Unmotivated
groep	Unmotivated
muizenval	Compound
pauze	Unmotivated
hond	Unmotivated
hond	Unmotivated
geld	Unmotivated
parelhoender	Compound
deken	Derivative
pluimp	Unmotivated
busjong	Compound
pil	Unmotivated
biertje	Derivative
pioen	Unmotivated
waakvlam	Compound
planetoïde	Derivative
luier	Unmotivated
fornuizen	Unmotivated
tekening	Derivative
stuk	Unmotivated
cape	Unmotivated
doel	Unmotivated
spaarpot	Compound
geheim	Unmotivated
kamer	Unmotivated
kinderkamer	Compound
plank	Unmotivated
wederhelft	Compound
goedkeuringsnummer	Compound
drukcilinder	Compound
maandagen	Unmotivated
stripfiguur	Compound
bed	Unmotivated
beek	Unmotivated
broeikasgasemissierecht	Compound
orde	Unmotivated
overgrootvader	Compound
haarlok	Compound
vlag	Unmotivated
cadetten	Unmotivated
betovergrootmoeder	Compound
vies	Unmotivated
biggetje	Derivative
meisje	Derivative
prins	Unmotivated
prins	Unmotivated
snijplank	Compound
toiletbril	Compound
probleem	Unmotivated
streep	Unmotivated
draad	Unmotivated
-ten	Compound
vinger	Derivative
ring	Unmotivated
taak	Unmotivated
linnenkast	Compound
lingerie	Derivative
poeder	Unmotivated
snijpunt	Compound
brief	Unmotivated
schoothond	Compound
vogel	Unmotivated
poedel	Unmotivated
fietspomp	Compound
punt	Unmotivated
pukkel	Unmotivated
lip	Unmotivated
huisvrouw	Compound
koekenpan	Compound
hotdog	Compound
paar	Unmotivated
hendels	Derivative
terrein	Unmotivated
letter	Unmotivated
liedje	Derivative
fluitje	Derivative
supervuisen	Derivative
punaise	Unmotivated
kaart	Unmotivated
product	Unmotivated
hut	Unmotivated
vriend	Unmotivated
monster	Derivative
helft	Unmotivated
kleerhanger	Compound
gezin	Unmotivated
mat	Unmotivated
rol	Unmotivated
loempia	Unmotivated
affaire	Unmotivated
boomkikker	Compound
plant	Unmotivated
prop	Unmotivated
meisje	Derivative
aanpakken	Compound
wijzers	Derivative
hand	Unmotivated
vis	Unmotivated
goudvis	Compound
vijver	Unmotivated
tekstvak	Compound
kooltje	Derivative
mannetje	Derivative
vrouw	Unmotivated
isoleercel	Compound
ambulance	Unmotivated
tekort	Compound
brievenbus	Compound
ontmoeting	Derivative
stuk	Unmotivated
madeliefje	Derivative
groep	Unmotivated
hakmes	Compound
zaad	Unmotivated
verpleegster	Derivative
padvinder	Compound
glas	Unmotivated
glas	Unmotivated
wijnkelder	Compound
objectglaas	Compound
maas	Unmotivated
mens	Unmotivated
vlek	Unmotivated
kast	Unmotivated
fee	Unmotivated
eierproductie	Compound
vrouw	Unmotivated
column	Unmotivated
kolom	Unmotivated
woord	Unmotivated
zon	Unmotivated
vraag	Unmotivated
tranen	Unmotivated
rietje	Derivative
woord	Unmotivated
natrium	Unmotivated
gaaien	Derivative
zoutvaa	Compound
materiaal	Derivative
siervoorwerp	Compound
mazel	Unmotivated
haarklemmen	Compound
grap	Unmotivated
hinde	Unmotivated
vrouw	Unmotivated
slachtafval	Compound
nachtkastje	Derivative
tafel	Unmotivated
barkruk	Compound
maaltijdbon	Compound
horloge-uurwerk	Compound
kerstboom	Compound
kerstboom	Compound
bladzijde	Compound
oom	Unmotivated
student	Derivative
lint	Unmotivated
ontvangstbewijzen	Compound
kiosk	Unmotivated
slipper	Derivative
deel	Unmotivated
bedrag	Compound
snack	Unmotivated
sweater	Derivative
troep	Unmotivated
toestel	Unmotivated
kaars	Unmotivated
tijd	Unmotivated
schepne	Derivative
medicijn	Derivative
tabel	Unmotivated
misja	Unmotivated
papa	Unmotivated
vader	Unmotivated
taxi	Unmotivated
tas	Unmotivated
tante	Unmotivated
ondertiteling	Compound
schoenveter	Compound
hand	Unmotivated
milf-wiet	Compound
prullaria	Unmotivated
t-shirt	Compound
clover	Unmotivated
driehoek	Compound
beetje	Derivative
tijd	Unmotivated
waterijsje	Derivative
bemonsteringspomp	Compound
snoetje	Derivative
schat	Unmotivated
fantasievorm	Compound
biervil	Compound
lijfje	Derivative
kers	Unmotivated
servet	Unmotivated
koolstofgehalte	Compound
steegje	Derivative
huilebalk	Compound
scone	Unmotivated
stad	Unmotivated
feest	Unmotivated
vork	Unmotivated
kaart	Unmotivated
rimpeling	Derivative
aanraken	Compound
trein	Unmotivated
lotion	Unmotivated
wodkaan	Compound
waterstof	Compound
soldaat	Derivative
zilverreiger	Compound
rolstoel	Compound
top	Unmotivated
rimpel	Unmotivated
kaapstander	Compound
dop	Unmotivated
moment	Unmotivated
monster	Derivative
lokflui	Compound
oorlog	Unmotivated
oprolas	Derivative
libel	Unmotivated
wijn	Derivative
deksel	Derivative
bamboescheuten	Compound
werkbijen	Compound
bije	Derivative
stuk	Unmotivated
aas	Unmotivated
bloem	Unmotivated
twijg	Unmotivated
bille	Unmotivated
tuin	Unmotivated
konijn	Derivative
hallo	Unmotivated
orde	Unmotivated
dief	Unmotivated
ijsje	Derivative
moedervlek	Compound
moedervlek	Compound
pupil	Unmotivated
vogel	Unmotivated
achteruitkijkspiegel	Compound
kern	Unmotivated
toiletten	Unmotivated
ambulance	Unmotivated
huis	Unmotivated
cocon	Unmotivated
zaad	Unmotivated
dekmantel	Compound
haak	Unmotivated
rank	Unmotivated
grijns	Unmotivated
thee	Unmotivated
hoofdband	Compound
capsule	Unmotivated
worm	Unmotivated
halter	Unmotivated
persoon	Unmotivated
artikel	Unmotivated
chocolaa	Unmotivated
hond	Unmotivated
-knop	Compound
stof	Unmotivated
bedrag	Compound
duivel	Unmotivated
mascara	Unmotivated
radijs	Unmotivated
textielband	Compound
raapzaad	Compound
ketting	Unmotivated
hok	Unmotivated
crèche	Unmotivated
ijsberg	Compound
schroef	Unmotivated
fototoestel	Compound
puppy	Unmotivated
thee	Unmotivated
theekop	Compound
chef	Unmotivated
rozenbottel	Compound
touw	Unmotivated
kikker	Unmotivated
entrecôte	Derivative
trap	Unmotivated
lijst	Unmotivated
schildpad	Compound
handboei	Compound
boeien	Unmotivated
vrouw	Unmotivated
streek	Unmotivated
barkruk	Compound
mens	Unmotivated
