vol	Unmotivated
relation	Derivative
belvédère	Unmotivated
fiole	Unmotivated
fille	Unmotivated
angelot	Derivative
camion	Unmotivated
grand-mère	Compound
colis	Unmotivated
béquille	Unmotivated
cravache	Unmotivated
bête	Unmotivated
bête	Unmotivated
chemise	Unmotivated
peur	Unmotivated
genièvre	Unmotivated
pain	Unmotivated
botte	Unmotivated
botte	Unmotivated
tempête	Unmotivated
téton	Derivative
chips	Unmotivated
chips	Unmotivated
contrat	Unmotivated
cousin	Unmotivated
frère	Unmotivated
pêche	Unmotivated
trésor	Unmotivated
brochure	Derivative
canneberge	Compound
paille	Unmotivated
bulle	Unmotivated
tympan	Unmotivated
twinkie	Derivative
appel	Unmotivated
veste	Unmotivated
jodhpur	Unmotivated
herbe	Unmotivated
appartement	Derivative
grand-mère	Compound
bouã	Derivative
estomac	Unmotivated
nom	Unmotivated
voie	Unmotivated
pavillon	Unmotivated
réfrigérateur	Derivative
homme	Unmotivated
type	Unmotivated
gâteau	Unmotivated
cheveu	Unmotivated
gars	Unmotivated
goût	Unmotivated
démunie	Derivative
moment	Unmotivated
temps	Unmotivated
accord	Unmotivated
défaut	Unmotivated
défaut	Unmotivated
babyphone	Compound
oignon	Unmotivated
cigarette	Derivative
gitane	Unmotivated
confiserie	Derivative
cœur	Unmotivated
sucre	Unmotivated
poitrine	Derivative
dépression	Derivative
plaquette	Derivative
couverture	Derivative
parasol	Compound
numéro	Unmotivated
faete	Unmotivated
médecin	Unmotivated
fossette	Derivative
maison	Unmotivated
gâteau	Unmotivated
gâteau	Unmotivated
vacance	Derivative
chère	Unmotivated
patte	Unmotivated
âme	Unmotivated
jardin	Unmotivated
porte	Derivative
dynamisme	Derivative
fille	Unmotivated
cadeau	Derivative
puzzle	Unmotivated
enfant	Unmotivated
enfant	Unmotivated
type	Unmotivated
grand-père	Compound
pute	Unmotivated
enfant	Unmotivated
bière	Unmotivated
chien	Unmotivated
violette	Derivative
figurine	Derivative
marqueur	Derivative
bouteille	Unmotivated
tache	Unmotivated
père	Unmotivated
outilleur	Derivative
forme	Unmotivated
chouchou	Unmotivated
tube	Unmotivated
chiffon	Unmotivated
chemisiers	Derivative
aluminium	Unmotivated
banane	Unmotivated
cône	Unmotivated
garçonnière	Derivative
heure	Unmotivated
montre	Unmotivated
colombe	Unmotivated
trésor	Unmotivated
ménagère	Derivative
bar	Unmotivated
hôtel	Unmotivated
caca	Unmotivated
heure	Unmotivated
frite	Unmotivated
tourtereau	Derivative
café	Unmotivated
tasse	Unmotivated
verre	Unmotivated
cendre	Unmotivated
raisin	Unmotivated
groupe	Unmotivated
haricot	Unmotivated
dendrocygne	Derivative
astérisque	Derivative
hameçon	Unmotivated
clou	Unmotivated
girofle	Unmotivated
baguette	Derivative
pomme	Unmotivated
langue	Unmotivated
unité	Unmotivated
pelote	Unmotivated
agneau	Unmotivated
crèche	Unmotivated
teckel	Unmotivated
étang	Unmotivated
espoir	Unmotivated
menu	Unmotivated
sac	Unmotivated
porte	Derivative
canard	Unmotivated
café	Unmotivated
culotte	Unmotivated
ami	Unmotivated
caillou	Unmotivated
canari	Unmotivated
lingette	Derivative
goutte	Unmotivated
chapelle	Derivative
poche	Unmotivated
chaperon	Derivative
note	Unmotivated
métal	Unmotivated
boîte	Unmotivated
canard	Unmotivated
propolis	Unmotivated
arbrisseau	Derivative
bâton	Derivative
marteau	Unmotivated
pouliche	Unmotivated
avocat	Unmotivated
chapeau	Unmotivated
boule	Unmotivated
clé	Unmotivated
manchette	Derivative
carnet	Unmotivated
livre	Unmotivated
directeur	Derivative
chou	Unmotivated
cheval	Unmotivated
eau	Unmotivated
stage	Unmotivated
scone	Unmotivated
genou	Unmotivated
cheville	Unmotivated
pointe	Unmotivated
théière	Derivative
passe-temps	Compound
boule	Unmotivated
couronne	Derivative
perle	Unmotivated
église	Unmotivated
cube	Unmotivated
cube	Unmotivated
tailleur	Derivative
chaudron	Unmotivated
pièce	Unmotivated
fond	Unmotivated
nichon	Derivative
valériane	Derivative
chat	Unmotivated
poussette	Derivative
racine	Derivative
nuisette	Derivative
fruit	Unmotivated
cupcake	Compound
chaton	Derivative
objet	Unmotivated
paysage	Derivative
vache	Unmotivated
crevette	Unmotivated
échine	Unmotivated
partie	Unmotivated
globule	Unmotivated
lapin	Unmotivated
lapin	Unmotivated
commerce	Unmotivated
beauté	Derivative
fois	Unmotivated
tête	Unmotivated
mante	Unmotivated
boucle	Unmotivated
mallette	Derivative
chatte	Derivative
put	Unmotivated
poussin	Unmotivated
levure	Derivative
fleur	Unmotivated
plante	Unmotivated
plante	Unmotivated
café	Unmotivated
silicium	Unmotivated
chaise	Unmotivated
croix	Unmotivated
cuticule	Unmotivated
flacon	Unmotivated
délicat	Unmotivated
lobe	Unmotivated
lumière	Derivative
ligne	Unmotivated
fouine	Unmotivated
banc	Unmotivated
niveau	Unmotivated
crâne	Unmotivated
réfrigérateur	Derivative
carton	Unmotivated
fille	Unmotivated
billet	Unmotivated
prospectu	Derivative
ligne	Unmotivated
bateau	Unmotivated
carénage	Derivative
navire	Unmotivated
céréale	Unmotivated
piège	Unmotivated
col	Unmotivated
cuillère	Derivative
pensée	Derivative
simili-ferme	Compound
orteil	Unmotivated
mari	Unmotivated
plan	Unmotivated
pommade	Derivative
fraîche	Unmotivated
mère	Unmotivated
mère	Unmotivated
compagnie	Derivative
animal	Derivative
machine	Unmotivated
ruban	Unmotivated
peluche	Unmotivated
accord	Unmotivated
enceinte	Unmotivated
minute	Unmotivated
crème	Unmotivated
moulin	Unmotivated
prière	Unmotivated
moment	Unmotivated
os	Unmotivated
farine	Unmotivated
cervelet	Unmotivated
congélateur	Derivative
carotte	Unmotivated
mini-attaque	Compound
ciel	Unmotivated
moule	Unmotivated
homme	Unmotivated
route	Unmotivated
place	Unmotivated
balle	Unmotivated
ville	Unmotivated
période	Derivative
grille	Unmotivated
corticostéroïde	Derivative
carte	Unmotivated
relation	Derivative
civière	Unmotivated
recherche	Derivative
pied	Unmotivated
bois	Unmotivated
matériel	Derivative
bocal	Unmotivated
hasard	Unmotivated
humeur	Unmotivated
dessin	Unmotivated
commerce	Unmotivated
vêtement	Derivative
visage	Derivative
nuage	Unmotivated
monture	Derivative
figure	Unmotivated
sécurité	Derivative
épinglette	Derivative
feu	Unmotivated
parc	Unmotivated
commissariat	Derivative
porte	Derivative
note	Unmotivated
singe	Unmotivated
corde	Unmotivated
âne	Unmotivated
numéro	Unmotivated
île	Unmotivated
mouton	Unmotivated
muscade	Unmotivated
patte	Unmotivated
poupée	Derivative
femme	Unmotivated
monsieur	Unmotivated
piment	Unmotivated
note	Unmotivated
partie	Unmotivated
piège	Unmotivated
pause	Unmotivated
chien	Unmotivated
chien	Unmotivated
pièce	Unmotivated
pintade	Compound
couverture	Derivative
plume	Unmotivated
serveur	Derivative
pilule	Unmotivated
verre	Unmotivated
pivoine	Unmotivated
flamme	Unmotivated
astéroïde	Derivative
début	Unmotivated
réchauds	Unmotivated
plan	Unmotivated
tranche	Unmotivated
cape	Unmotivated
intérêt	Unmotivated
pépette	Derivative
secret	Unmotivated
pièce	Unmotivated
pièce	Unmotivated
étagère	Derivative
moitié	Unmotivated
nom	Unmotivated
dispositif	Derivative
lundi	Unmotivated
figurine	Derivative
berceau	Derivative
rivière	Unmotivated
quotas	Unmotivated
accord	Unmotivated
arrière-grand-père	Compound
cheveu	Unmotivated
drapeau	Derivative
enseigne	Unmotivated
arrière-arrière-grand-mère	Compound
cochon	Derivative
cochon	Derivative
fesse	Unmotivated
princesse	Derivative
prince	Unmotivated
toilette	Derivative
siège	Unmotivated
problème	Unmotivated
catgut	Compound
fil	Unmotivated
argot	Unmotivated
eastland	Compound
bague	Unmotivated
travail	Unmotivated
commode	Unmotivated
sous-vêtement	Compound
poudre	Unmotivated
intersection	Derivative
mot	Unmotivated
chien	Unmotivated
oiseau	Derivative
caniche	Unmotivated
pompe	Unmotivated
point	Unmotivated
bouton	Unmotivated
meringue	Unmotivated
ménagère	Derivative
poêle	Unmotivated
saucisse	Unmotivated
couple	Unmotivated
bouton	Unmotivated
territoire	Derivative
lettre	Unmotivated
chanson	Unmotivated
sifflet	Derivative
poing	Unmotivated
badge	Unmotivated
carte	Unmotivated
préparation	Derivative
abri	Unmotivated
ami	Unmotivated
créature	Derivative
moitié	Unmotivated
cintre	Unmotivated
famille	Unmotivated
paillasson	Derivative
rôle	Unmotivated
rouleau	Derivative
idylle	Unmotivated
rainette	Derivative
plante	Unmotivated
bâillon	Derivative
fille	Unmotivated
ménag	Derivative
aiguille	Unmotivated
main	Unmotivated
forme	Unmotivated
poisson	Unmotivated
étang	Unmotivated
cadre	Unmotivated
rose	Unmotivated
essai	Unmotivated
femelle	Unmotivated
mitard	Derivative
ambulance	Unmotivated
déficit	Unmotivated
boîte	Unmotivated
réunion	Derivative
numéro	Unmotivated
pâquerette	Derivative
chiffre	Unmotivated
pic	Unmotivated
graine	Unmotivated
docteur	Derivative
scout	Unmotivated
verre	Unmotivated
eau	Unmotivated
cave	Unmotivated
montre	Unmotivated
faille	Unmotivated
réunion	Derivative
tache	Unmotivated
boîte	Unmotivated
lutin	Unmotivated
poule	Unmotivated
femme	Unmotivated
article	Unmotivated
colonne	Derivative
moment	Unmotivated
soleil	Unmotivated
besoin	Derivative
larme	Unmotivated
paille	Unmotivated
mot	Unmotivated
sodium	Unmotivated
geais	Unmotivated
salière	Derivative
dispositif	Derivative
statue	Unmotivated
rubéole	Unmotivated
trombone	Derivative
temps	Unmotivated
biche	Unmotivated
femme	Unmotivated
lapins	Unmotivated
chevet	Unmotivated
table	Unmotivated
éclisse	Unmotivated
coupon	Unmotivated
machine	Unmotivated
sapin	Unmotivated
sapin	Unmotivated
site	Unmotivated
oncle	Unmotivated
goldschläger	Compound
ruban	Unmotivated
recette	Unmotivated
stand	Unmotivated
chaussure	Derivative
morceau	Derivative
argent	Unmotivated
faim	Unmotivated
gilet	Unmotivated
dégât	Unmotivated
clamp	Unmotivated
bougie	Unmotivated
fiston	Unmotivated
résille	Unmotivated
pilule	Unmotivated
tableau	Derivative
jeu	Unmotivated
papa	Unmotivated
père	Unmotivated
taxi	Unmotivated
spécialité	Derivative
tatie	Unmotivated
sous-titre	Compound
chaussure	Derivative
main	Unmotivated
herbe	Unmotivated
babiole	Unmotivated
t-shirt	Compound
trèfle	Unmotivated
triangle	Derivative
monde	Unmotivated
eau	Unmotivated
solero	Derivative
tube	Unmotivated
minois	Unmotivated
citrouille	Unmotivated
fromage	Derivative
plateau	Derivative
corps	Unmotivated
cerise	Unmotivated
serviette	Unmotivated
carbone	Unmotivated
impasse	Derivative
pleurnicheur	Derivative
muffin	Unmotivated
village	Unmotivated
fête	Unmotivated
fourchette	Derivative
signature	Unmotivated
flots	Unmotivated
cheveu	Unmotivated
train	Unmotivated
lotion	Unmotivated
verre	Unmotivated
hydrogène	Compound
soldat	Unmotivated
héron	Unmotivated
chariot	Unmotivated
sommet	Unmotivated
sourcil	Unmotivated
cabestan	Unmotivated
sommet	Unmotivated
besoin	Derivative
échantillonnage	Derivative
appât	Unmotivated
guerre	Unmotivated
raclette	Derivative
doute	Unmotivated
vin	Unmotivated
couvercle	Unmotivated
plante	Unmotivated
abeille	Unmotivated
abeille	Unmotivated
matériel	Derivative
appât	Unmotivated
fleur	Unmotivated
branche	Unmotivated
queue	Unmotivated
cour	Unmotivated
lapin	Unmotivated
blushe	Unmotivated
accord	Unmotivated
voleur	Derivative
glace	Unmotivated
marque	Unmotivated
cutie	Unmotivated
pupille	Unmotivated
chanteur	Derivative
rétroviseur	Derivative
grain	Unmotivated
toilette	Derivative
ambulance	Unmotivated
chasse	Unmotivated
cocon	Unmotivated
spore	Unmotivated
bavette	Derivative
astérisque	Derivative
vrille	Unmotivated
grimace	Unmotivated
thé	Unmotivated
serre-tête	Compound
capuchon	Derivative
bonbon	Unmotivated
haltère	Unmotivated
man	Unmotivated
article	Unmotivated
chocolat	Unmotivated
chien	Unmotivated
bouton	Unmotivated
morceau	Derivative
somme	Unmotivated
démon	Unmotivated
mascara	Unmotivated
radis	Unmotivated
sandales	Unmotivated
colza	Unmotivated
collier	Unmotivated
boîte	Unmotivated
pépinière	Derivative
pointe	Unmotivated
boulon	Derivative
plaque	Unmotivated
chiot	Derivative
tasse	Unmotivated
coupe	Unmotivated
chef	Unmotivated
eglantine	Unmotivated
fil	Unmotivated
grenouille	Unmotivated
porc	Unmotivated
échelle	Unmotivated
liste	Unmotivated
tortue	Unmotivated
menotte	Unmotivated
menotte	Unmotivated
femme	Unmotivated
farce	Unmotivated
chaise	Unmotivated
âme	Unmotivated
