aerolínea	Derivative
aventura	Derivative
glorieta	Derivative
frasco	Unmotivated
charlie	Unmotivated
ángel	Unmotivated
coche	Unmotivated
abuela	Unmotivated
paquete	Derivative
muleta	Unmotivated
fusta	Unmotivated
tipo	Derivative
tonto	Unmotivated
blusa	Unmotivated
caca	Unmotivated
enebro	Unmotivated
queso	Unmotivated
zapatito	Derivative
zapato	Unmotivated
tormenta	Unmotivated
pezón	Derivative
papa	Unmotivated
papas	Unmotivated
portería	Derivative
primojoey	Unmotivated
hermanito	Derivative
melocotón	Derivative
vida	Unmotivated
folleto	Derivative
arándano	Derivative
sorbete	Derivative
burbuja	Unmotivated
tímpano	Derivative
pastel	Unmotivated
atención	Derivative
chaqueta	Derivative
bombín	Unmotivated
hierba	Unmotivated
lugar	Derivative
gram-gram	Compound
boya	Unmotivated
barriguita	Derivative
placa	Unmotivated
forma	Unmotivated
cabina	Unmotivated
side-by-side	Compound
hijo	Derivative
persona	Unmotivated
pan	Unmotivated
pelito	Derivative
persona	Unmotivated
impulso	Derivative
chica	Unmotivated
burt	Unmotivated
tiempo	Unmotivated
momento	Unmotivated
error	Unmotivated
error	Unmotivated
cámara	Unmotivated
cebolla	Unmotivated
cigarrillo	Derivative
gitana	Unmotivated
confitería	Derivative
caramelo	Derivative
caramelo	Derivative
catéter	Derivative
depresión	Derivative
plaqueta	Derivative
manta	Derivative
paragua	Unmotivated
acto	Unmotivated
golosina	Derivative
médico	Unmotivated
hoyuelo	Derivative
casa	Unmotivated
cupcak	Compound
chuletón	Derivative
licencia	Derivative
cielitos	Derivative
garra	Unmotivated
alma	Unmotivated
jardín	Derivative
puerta	Unmotivated
dinamismo	Derivative
mujer	Unmotivated
pieza	Unmotivated
parte	Unmotivated
hijo	Derivative
niña	Unmotivated
tipo	Derivative
abuelo	Unmotivated
puta	Unmotivated
niña	Unmotivated
jarra	Unmotivated
perro	Unmotivated
llago	Unmotivated
figurita	Derivative
marcador	Derivative
botella	Derivative
jirafita	Derivative
padre	Unmotivated
cepillador	Derivative
forma	Unmotivated
banda	Unmotivated
vía	Unmotivated
cosa	Unmotivated
blusa	Unmotivated
aluminio	Derivative
maniquer	Derivative
cono	Unmotivated
lugar	Derivative
reloj	Unmotivated
reloj	Unmotivated
paloma	Unmotivated
niña	Unmotivated
casa	Unmotivated
bar	Unmotivated
pensión	Derivative
caca	Unmotivated
hora	Unmotivated
papas	Unmotivated
paloma	Unmotivated
café	Unmotivated
taza	Unmotivated
copa	Unmotivated
hueso	Unmotivated
pasita	Derivative
persona	Unmotivated
arveja	Unmotivated
ñoña	Unmotivated
punto	Unmotivated
condición	Derivative
clavo	Derivative
clavo	Derivative
palillo	Derivative
tomate	Unmotivated
lengua	Unmotivated
unidad	Derivative
alfiletero	Derivative
cordero	Derivative
pesebre	Derivative
dachshund	Compound
piscina	Unmotivated
luz	Unmotivated
menú	Unmotivated
cosa	Unmotivated
probador	Derivative
pato	Unmotivated
café	Unmotivated
calzón	Derivative
amigo	Unmotivated
piedra	Unmotivated
pinzón	Derivative
pañuelo	Derivative
gota	Unmotivated
santuario	Derivative
bolsa	Unmotivated
caperucita	Derivative
identificación	Derivative
cepillo	Derivative
caja	Unmotivated
pato	Unmotivated
propóleo	Derivative
azucenas	Compound
rama	Unmotivated
mazo	Unmotivated
potrilla	Derivative
laguna	Unmotivated
gorro	Derivative
glomérulo	Derivative
germen	Unmotivated
botón	Derivative
libro	Unmotivated
libro	Unmotivated
director	Derivative
donut	Derivative
potranca	Derivative
grifo	Unmotivated
pieza	Unmotivated
brownie	Derivative
knockwurst	Compound
clavija	Unmotivated
huella	Unmotivated
tetera	Derivative
pasatiempo	Compound
bola	Unmotivated
corona	Unmotivated
abalorio	Unmotivated
iglesia	Unmotivated
hueso	Unmotivated
cubos	Unmotivated
conjunto	Derivative
caldero	Derivative
parte	Unmotivated
rabillo	Derivative
cabra	Unmotivated
cabra	Unmotivated
gato	Unmotivated
anexo	Unmotivated
raíz	Unmotivated
camisón	Derivative
cesta	Unmotivated
cacahuete	Derivative
gatito	Derivative
cajita	Derivative
paisaje	Derivative
vaca	Unmotivated
gamba	Unmotivated
espinazo	Derivative
equipo	Derivative
glóbulo	Unmotivated
conejo	Unmotivated
conejo	Unmotivated
tiendita	Derivative
belleza	Derivative
punto	Unmotivated
cara	Unmotivated
mantis	Unmotivated
rizo	Unmotivated
portafolio	Unmotivated
mujer	Unmotivated
zorra	Derivative
pollito	Derivative
levadura	Derivative
flor	Unmotivated
planta	Unmotivated
planta	Unmotivated
café	Unmotivated
silicio	Derivative
silla	Unmotivated
cruz	Unmotivated
cutícula	Derivative
frasco	Unmotivated
queso	Unmotivated
lóbulo	Unmotivated
luz	Unmotivated
línea	Unmotivated
comadrejas	Compound
banquillo	Derivative
listón	Derivative
calavera	Derivative
refrigerador	Derivative
cartón	Derivative
gays	Unmotivated
billete	Derivative
cartel	Unmotivated
línea	Unmotivated
barco	Derivative
omóplato	Unmotivated
barco	Derivative
copo	Unmotivated
emboscada	Derivative
camisa	Unmotivated
cucharo	Derivative
pensamiento	Derivative
comestibles--	Compound
meñique	Derivative
esposo	Derivative
mapa	Unmotivated
crema	Unmotivated
carne	Unmotivated
madre	Unmotivated
tierra	Unmotivated
mascota	Unmotivated
mascota	Unmotivated
máquina	Unmotivated
moño	Derivative
caramelo	Derivative
cariño	Derivative
hijo	Derivative
momento	Unmotivated
leche	Unmotivated
molinillo	Derivative
oración	Derivative
momento	Unmotivated
médula	Derivative
harina	Unmotivated
cerebro	Unmotivated
congelador	Derivative
zanahoria	Derivative
ataque	Unmotivated
cielo	Derivative
concha	Unmotivated
hombre	Unmotivated
ratón	Derivative
punto	Unmotivated
bola	Unmotivated
comunidad	Derivative
mes	Unmotivated
cuadrícula	Derivative
corticosteroid	Compound
tarjeta	Derivative
hilo	Unmotivated
camilla	Derivative
noticia	Derivative
piececito	Derivative
vaso	Unmotivated
parte	Unmotivated
caperuza	Derivative
posibilidad	Derivative
humor	Unmotivated
boceto	Unmotivated
negocio	Unmotivated
conjunto	Derivative
cara	Unmotivated
zixia	Unmotivated
montura	Unmotivated
figura	Unmotivated
seguridad	Derivative
placa	Unmotivated
fuego	Unmotivated
parque	Unmotivated
distrito	Derivative
punto	Unmotivated
nota	Unmotivated
canija	Derivative
soga	Unmotivated
burro	Unmotivated
mesa	Unmotivated
islote	Derivative
oveja	Unmotivated
problema	Derivative
conejo	Unmotivated
muñeca	Derivative
mujer	Unmotivated
señor	Derivative
cúrcuma	Unmotivated
tornasol	Compound
equipo	Derivative
trampa	Unmotivated
descanso	Derivative
perro	Unmotivated
perro	Unmotivated
moneda	Unmotivated
rombo	Unmotivated
manta	Derivative
pluma	Unmotivated
botón	Derivative
pastilla	Derivative
cerveza	Unmotivated
peonía	Derivative
flamey	Derivative
planetoide	Compound
niño	Derivative
cocción	Unmotivated
plan	Unmotivated
rodaja	Derivative
capa	Unmotivated
interés	Unmotivated
caja	Unmotivated
silencio	Derivative
habitación	Derivative
sala	Unmotivated
libro	Unmotivated
parte	Unmotivated
guión	Derivative
dispositivo	Derivative
semana	Unmotivated
figura	Unmotivated
cuna	Unmotivated
arroyo	Derivative
emisión	Unmotivated
acuerdo	Derivative
bisabuelo	Derivative
mechón	Derivative
gallardete	Derivative
alférez	Unmotivated
bisabuela	Derivative
sexo	Derivative
hucha	Unmotivated
culo	Unmotivated
princesita	Derivative
príncipe	Unmotivated
asiento	Unmotivated
asiento	Unmotivated
problema	Derivative
peso	Unmotivated
hilo	Unmotivated
dedo	Unmotivated
dedo	Unmotivated
alianza	Derivative
asunto	Derivative
ropa	Unmotivated
lencería	Derivative
polvo	Unmotivated
intersección	Derivative
carta	Unmotivated
faldero	Derivative
polluelo	Derivative
caniche	Unmotivated
inflador	Derivative
punto	Unmotivated
mancha	Unmotivated
merengue	Unmotivated
ama	Unmotivated
sartén	Unmotivated
dog	Unmotivated
par	Unmotivated
palanca	Unmotivated
territorio	Derivative
letra	Unmotivated
canción	Unmotivated
silbato	Unmotivated
dormías	Compound
chincheta	Derivative
carta	Unmotivated
producto	Derivative
refugio	Derivative
amigo	Unmotivated
criatura	Unmotivated
mitad	Unmotivated
hombro	Derivative
familia	Unmotivated
alfombra	Unmotivated
papel	Unmotivated
rollo	Unmotivated
aventura	Derivative
meteoróloga	Derivative
planta	Unmotivated
mordaza	Derivative
mujer	Unmotivated
cuidado	Derivative
manecilla	Derivative
mano	Unmotivated
forma	Unmotivated
pez	Unmotivated
estanque	Unmotivated
recuadro	Derivative
longbeach	Compound
concentración	Derivative
hembra	Unmotivated
aislamiento	Derivative
ambulancia	Derivative
déficit	Unmotivated
caja	Unmotivated
reunión	Derivative
cambio	Unmotivated
margarita	Derivative
final	Derivative
picahielo	Derivative
semilla	Unmotivated
enfermera	Derivative
explorador	Derivative
copa	Unmotivated
copa	Unmotivated
alvéolo	Derivative
portaobjeto	Derivative
grieta	Unmotivated
equipo	Derivative
mancha	Unmotivated
empújame	Unmotivated
duendecillo	Derivative
gallina	Unmotivated
mujer	Unmotivated
it	Unmotivated
columna	Unmotivated
momento	Unmotivated
sol	Unmotivated
servicio	Unmotivated
lágrima	Unmotivated
pajita	Derivative
palabra	Unmotivated
sodio	Unmotivated
arrendajo	Derivative
salero	Derivative
pieza	Unmotivated
estatuilla	Derivative
sarampión	Derivative
máquina	Unmotivated
juego	Unmotivated
ciervo	Derivative
anciana	Derivative
conejo	Unmotivated
mesita	Derivative
mesa	Unmotivated
taburete	Derivative
comida	Unmotivated
relojería	Derivative
adorno	Derivative
arbolito	Derivative
página	Derivative
tío	Unmotivated
estudiante	Derivative
lazo	Unmotivated
bono	Unmotivated
stand	Unmotivated
zapatilla	Derivative
parte	Unmotivated
suma	Unmotivated
comida	Unmotivated
suéter	Derivative
desastre	Derivative
borne	Unmotivated
vela	Unmotivated
favor	Unmotivated
redecilla	Derivative
píldora	Derivative
cuadro	Unmotivated
danza	Unmotivated
guapo	Unmotivated
padre	Unmotivated
taxi	Unmotivated
dumpling	Derivative
t	Unmotivated
subtítulo	Derivative
cordón	Derivative
huella	Unmotivated
hierba	Unmotivated
basura	Unmotivated
camiseta	Derivative
trébol	Derivative
«rayos»3	Derivative
problema	Derivative
nt	Derivative
enano	Derivative
tubo	Unmotivated
cara	Unmotivated
cariño	Derivative
hierro	Derivative
posavaso	Derivative
cuerpito	Derivative
cereza	Derivative
servilleta	Derivative
carbono	Derivative
callejón	Derivative
llorón	Derivative
panecillo	Derivative
pueblo	Unmotivated
fiesta	Unmotivated
tenedor	Derivative
tarjeta	Derivative
onda	Unmotivated
daño	Derivative
tren	Unmotivated
loción	Derivative
vodka	Derivative
hidrógeno	Derivative
soldadito	Derivative
garza	Unmotivated
rueda	Unmotivated
cima	Unmotivated
arruga	Derivative
puerta	Unmotivated
camiseta	Derivative
momento	Unmotivated
muestreo	Derivative
señuelo	Derivative
guerra	Unmotivated
rodillo	Derivative
libélula	Unmotivated
finard	Derivative
tapa	Unmotivated
calabrese	Unmotivated
abeja	Unmotivated
abeja	Unmotivated
pieza	Unmotivated
cebo	Unmotivated
flor	Unmotivated
rama	Unmotivated
culo	Unmotivated
campo	Unmotivated
conejito	Derivative
salud	Unmotivated
cariño	Derivative
ladronzuelo	Derivative
heladería	Derivative
marca	Unmotivated
marca	Unmotivated
pupila	Unmotivated
cantora	Unmotivated
retrovisor	Derivative
semilla	Unmotivated
lavabo	Unmotivated
ambulancia	Derivative
palacete	Derivative
capullo	Unmotivated
espora	Unmotivated
tapadera	Derivative
paréntesis	Derivative
zarcillo	Derivative
cara	Unmotivated
julep	Unmotivated
diadema	Unmotivated
gorro	Derivative
lombriz	Derivative
pesa	Unmotivated
persona	Unmotivated
artículo	Unmotivated
chocolate	Unmotivated
perro	Unmotivated
botón	Derivative
residuo	Derivative
importe	Derivative
diablillo	Derivative
rímel	Derivative
rábano	Derivative
palmilla	Derivative
colza	Unmotivated
reloj	Unmotivated
etiqueta	Derivative
guardería	Derivative
punta	Unmotivated
tornillo	Derivative
placa	Unmotivated
cachorro	Derivative
taza	Unmotivated
bandejas	Compound
jefe	Unmotivated
escaramujo	Derivative
hilo	Unmotivated
rana	Unmotivated
carne	Unmotivated
escalera	Derivative
lista	Unmotivated
tortuguita	Derivative
esposa	Unmotivated
cosa	Unmotivated
mujer	Unmotivated
broma	Unmotivated
silla	Unmotivated
alma	Unmotivated
