beles	Unmotivated
sharpston	Compound
vertegenwoordiger	Derivative
activist	Derivative
amateur	Derivative
anarchist	Derivative
engelwortel	Compound
anesthesist	Derivative
antropoloog	Unmotivated
archeoloog	Unmotivated
architect	Unmotivated
aromatherapeut	Compound
assistent	Derivative
astronaut	Derivative
atlete	Derivative
auteur	Derivative
bankier	Derivative
barmeid	Compound
barones	Unmotivated
bioloog	Unmotivated
idioot	Unmotivated
blog-moeder	Compound
blondine	Unmotivated
vechter	Derivative
pistool	Unmotivated
roller	Derivative
drummer	Derivative
dichteres	Derivative
hardloopster	Compound
celliste	Derivative
douane	Unmotivated
fabriek	Unmotivated
choreograaf	Unmotivated
voogd	Unmotivated
vreemdeling	Derivative
echtbreekster	Compound
patissier	Derivative
trainer	Derivative
keizerin	Derivative
dealer	Derivative
diagnose	Derivative
tegel	Unmotivated
uitlogingspotentieel	Compound
koppelaarster	Derivative
dokter	Unmotivated
conciërge	Derivative
bijlesmeisje	Compound
bewaker	Derivative
draak	Unmotivated
storen	Unmotivated
dubbelganger	Compound
donordieren	Derivative
demon	Unmotivated
erfgenaam	Compound
decaan	Derivative
werkbij	Compound
agent	Derivative
redacteur	Derivative
ex-vrouw	Compound
groupie	Unmotivated
boerin	Compound
feminist	Derivative
meisje	Unmotivated
junkie	Unmotivated
finalist	Derivative
fotograaf	Unmotivated
fysiotherapeutten	Derivative
geoloog	Unmotivated
golfer	Derivative
gouverneur	Derivative
turnster	Derivative
gynaecoloog	Compound
actrice	Derivative
nieuwslezeres	Compound
opsporingsbevel	Compound
babysitter	Compound
hobospeelster	Compound
duif	Unmotivated
achtervolging	Compound
huishoudster	Compound
gastvrouw	Compound
gastvrouw	Compound
violist	Unmotivated
gravin	Unmotivated
heldin	Derivative
speelster	Derivative
musicus	Unmotivated
zondares	Derivative
illustrator	Derivative
indiaans	Compound
informante	Derivative
inspecteur	Derivative
instructeur	Derivative
stagiaire	Derivative
technicus	Unmotivated
helderzien	Compound
student	Derivative
paardrijdster	Compound
hagedis	Unmotivated
zee-egel	Compound
kapper	Derivative
vriend	Unmotivated
cameravrouw	Compound
raydor	Compound
eend	Unmotivated
clientèle	Derivative
cliënt	Derivative
petekind	Compound
bibliothecaris	Unmotivated
priesteres	Derivative
collega	Unmotivated
commissaris	Unmotivated
congreslid	Compound
concurrent	Derivative
coordinator	Derivative
goochelaar	Derivative
cowgirl	Compound
schnaps	Unmotivated
stuk	Unmotivated
schaatster	Derivative
csi	Unmotivated
criminelen	Unmotivated
kristal	Derivative
kok	Unmotivated
curator	Derivative
kegel	Unmotivated
bloemist	Derivative
meisje	Unmotivated
links	Unmotivated
leugenaar	Derivative
huntress	Derivative
arts	Unmotivated
genezer	Derivative
eigenares	Derivative
schilder	Unmotivated
manicure	Unmotivated
vrouw	Unmotivated
visagissen	Unmotivated
masochist	Derivative
masseuse	Derivative
berin	Derivative
mentor	Unmotivated
minnares	Derivative
mevrouw	Derivative
minister	Unmotivated
model	Unmotivated
presentatrice	Derivative
camouflagekleding	Compound
motor	Unmotivated
muzikante	Derivative
martelares	Derivative
cheer-nazi	Compound
sukkel	Unmotivated
drug	Unmotivated
notaris	Unmotivated
journalist	Derivative
vrouw	Unmotivated
gnocchi	Unmotivated
reserve	Unmotivated
huurster	Derivative
náměstkyně	Derivative
opvolgster	Compound
ontwerper	Derivative
zakenvrouw	Compound
bewonderaar	Derivative
verdediging	Derivative
favoriet	Unmotivated
inwoonster	Compound
beschermster	Derivative
expert	Unmotivated
scherpschuttergeweer	Compound
babysitter	Compound
voogd	Unmotivated
operator	Derivative
organisator	Derivative
feestvark	Compound
opening	Unmotivated
slaaf	Unmotivated
verpleegster	Derivative
patiënt	Derivative
hamer	Unmotivated
magen	Unmotivated
vorst	Unmotivated
mevrouw	Derivative
vloei	Unmotivated
afspraak	Compound
partner	Unmotivated
passagier	Derivative
krijt	Unmotivated
herderinnetje	Compound
patholoog	Unmotivated
sponsor	Unmotivated
kinderarts	Compound
bakker	Derivative
verpleegster	Derivative
pianiste	Derivative
pierogie	Derivative
zwemmer	Derivative
hoer	Unmotivated
zakenvrouw	Compound
oplichtster	Compound
schatkist	Compound
agent	Derivative
politieagente	Derivative
politica	Derivative
hulp	Unmotivated
adviseur	Derivative
luitenant	Unmotivated
luisteraar	Derivative
probleem	Unmotivated
werkster	Derivative
stagiaire	Derivative
recht	Unmotivated
premier	Unmotivated
voorzitter	Compound
prinses	Derivative
verkoopster	Derivative
producer	Derivative
docent	Derivative
aanklager	Compound
prostituees	Unmotivated
eerstejaar	Compound
advocaat	Unmotivated
advocaat	Unmotivated
pionier	Unmotivated
psycholoog	Unmotivated
storen	Unmotivated
psychotherapeutten	Compound
tienermeis	Compound
publiciteitsagent	Compound
preut	Unmotivated
typist	Derivative
operazangeres	Compound
voorganger	Compound
voorzitster	Compound
vertaalster	Derivative
vampierdoder	Compound
vriendin	Derivative
redacteur	Derivative
regente	Derivative
journalist	Derivative
assistent	Derivative
cheerleader	Compound
wijfje	Derivative
koormeisje	Compound
verzamelaar	Derivative
schrijver	Derivative
secretaresse	Derivative
amidala	Unmotivated
padvindster	Compound
componissen	Unmotivated
dienaar	Derivative
vrouw	Unmotivated
recht	Unmotivated
buurvrouw	Compound
specialist	Unmotivated
noodonderbreking	Compound
teamgenoot	Compound
passagier	Derivative
partner	Unmotivated
klasgenoo	Compound
atlete	Derivative
burgemeester	Compound
stenotypissen	Compound
liftster	Derivative
stripper	Derivative
hoedster	Derivative
agent	Derivative
student	Derivative
maker	Derivative
examen	Unmotivated
stagiaire	Derivative
scholier	Unmotivated
schutter	Derivative
superheldin	Derivative
topmodel	Compound
huwelijk	Derivative
vraag	Unmotivated
pupil	Unmotivated
verleidster	Derivative
verleidster	Derivative
minister	Unmotivated
tiener	Derivative
tennisster	Derivative
therapeut	Unmotivated
terrorist	Unmotivated
copywriter	Compound
tolk	Unmotivated
dikzak	Compound
trainer	Derivative
dwergvrouw	Compound
stengel	Unmotivated
buis	Unmotivated
wegloopster	Compound
toerist	Derivative
potlode	Compound
kandidaat	Derivative
schoonmaakster	Compound
kunstenaar	Derivative
vluchteling	Derivative
leerling	Derivative
lerares	Derivative
leiding	Derivative
ambassadeur	Derivative
boerin	Compound
dierenarts	Compound
vicepresident	Derivative
keizerin	Derivative
schorseneren	Derivative
netnummer	Compound
volleybalster	Compound
moordenaar	Derivative
gouvernante	Derivative
uitgeefster	Compound
student	Derivative
onderzoekster	Compound
winnares	Derivative
wetenschapster	Derivative
spiritist	Derivative
waarzegster	Compound
leidster	Compound
tuinier	Derivative
vangen	Unmotivated
oprichter	Compound
werkneemster	Compound
werkgeefster	Compound
stenograaf	Unmotivated
arsenaal	Unmotivated
corpsman	Compound
goudzoeker	Compound
autodief	Derivative
zangeres	Derivative
roden	Unmotivated
verraadster	Derivative
tandarts	Unmotivated
spionnen	Unmotivated
paramedicus	Derivative
vrouw	Unmotivated
worstelaar	Derivative
vertegenwoordiger	Derivative
honden-kidnapper	Compound
aanvalster	Compound
partij	Unmotivated
heks	Unmotivated
heks	Unmotivated
negerin	Derivative
commissie	Derivative
lezer	Derivative
serveerster	Derivative
duivelin	Derivative
directrice	Derivative
bestuurster	Derivative
schaakbord	Compound
garderobejuffrouw	Compound
sheriff	Unmotivated
schoolmeisje	Compound
spionage	Derivative
kwast	Unmotivated
vraag	Unmotivated
chef-kekken	Compound
baas	Unmotivated
hoofdredacteur	Compound
verzoekster	Derivative
bedelares	Derivative
joods	Derivative
journalistiek	Derivative
student	Derivative
