выпускница	Derivative
адвокат	Derivative
агент	Unmotivated
активистка	Derivative
дилетантка	Derivative
анархистка	Derivative
дудник	Derivative
анестезиолог	Compound
антрополог	Compound
археолог	Compound
архитектор	Derivative
ароматерапевтор	Derivative
помощник	Derivative
космонавт	Compound
спортсменка	Derivative
автор	Unmotivated
банкирш	Derivative
бармен	Unmotivated
баронесса	Derivative
биолог	Unmotivated
идиотка	Derivative
блоггер	Unmotivated
блондинка	Derivative
боец	Derivative
пушка	Derivative
фигуристка	Derivative
барабанщица	Derivative
поэтесс	Unmotivated
бегунья	Derivative
виолончелистка	Derivative
таможня	Derivative
комбинат	Derivative
хореограф	Derivative
протежй	Derivative
незнакомка	Derivative
прелюбодейка	Derivative
кондитер	Derivative
инструктор	Derivative
императрица	Derivative
дилер	Unmotivated
диагноз	Derivative
плитка	Derivative
док	Derivative
сводница	Derivative
др	Derivative
консьержка	Derivative
репетитор	Derivative
охранник	Derivative
дракон	Unmotivated
неформалка	Derivative
двойник	Derivative
донор	Derivative
демон	Unmotivated
наследница	Derivative
декан	Derivative
рабоч	Unmotivated
офицер	Unmotivated
редактор	Derivative
жена	Unmotivated
поклонница	Derivative
фермерш	Unmotivated
феминистка	Derivative
милашка	Derivative
наркоманка	Derivative
финалистка	Derivative
фотограф	Derivative
физиотерапевт	Unmotivated
геолог	Unmotivated
гольфистка	Derivative
одегард	Unmotivated
гимнастка	Derivative
гинеколог	Derivative
актриса	Derivative
дикторша	Derivative
розыск	Derivative
няня	Unmotivated
гобоистка	Derivative
голубь	Derivative
погоня	Unmotivated
экономка	Derivative
официантка	Derivative
хозяйка	Derivative
скрипачка	Derivative
графиня	Derivative
героиня	Derivative
игрок	Unmotivated
музыкантка	Derivative
грешница	Derivative
иллюстратор	Derivative
меномини	Derivative
информатор	Derivative
инспектор	Derivative
инструктор	Derivative
интерн	Unmotivated
инженер	Derivative
гадалка	Derivative
отличница	Derivative
наездница	Derivative
ящерица	Derivative
светоёжик	Derivative
парикмахер	Derivative
подруга	Derivative
оператор	Derivative
рэйдор	Unmotivated
утка	Derivative
клиентура	Derivative
клиентка	Derivative
крестница	Derivative
библиотекарша	Derivative
жрица	Derivative
коллега	Derivative
суперинтендант	Derivative
конгресс	Derivative
соперница	Derivative
координатор	Derivative
волшебница	Derivative
ковбойша	Derivative
выпивка	Derivative
красавица	Derivative
фигуристка	Derivative
криминалист	Derivative
преступница	Derivative
оксалата	Derivative
кухарка	Derivative
куратор	Derivative
кеголь	Unmotivated
цветочница	Derivative
друг	Unmotivated
левша	Unmotivated
лгунье	Unmotivated
охотница	Derivative
доктор	Unmotivated
целитель	Derivative
хозяйка	Derivative
художница	Derivative
маникюрша	Derivative
жена	Unmotivated
гример	Unmotivated
мазохистка	Derivative
массажистка	Derivative
медведица	Derivative
наставник	Derivative
любовница	Derivative
светлость	Derivative
госсекретарь	Derivative
модель	Unmotivated
ведущий	Derivative
комбинезон	Derivative
мотоцикл	Compound
музыкант	Derivative
мученица	Derivative
нацистка	Derivative
сосунок	Derivative
наркоманка	Derivative
нотариус	Unmotivated
журналист	Derivative
жена	Unmotivated
начинка	Derivative
дублерш	Derivative
квартирантка	Derivative
генсек	Unmotivated
преемник	Derivative
дизайнер	Derivative
торговка	Derivative
поклонница	Derivative
защита	Derivative
любимица	Derivative
жительница	Derivative
защитница	Derivative
специалист	Derivative
винтовка	Derivative
сиделка	Derivative
опекун	Unmotivated
оператор	Derivative
организатор	Derivative
именинница	Derivative
открытие	Derivative
рабынь	Unmotivated
сиделка	Derivative
пациент	Unmotivated
молоток	Derivative
дева	Derivative
монарх	Unmotivated
госпожа	Derivative
бумага	Unmotivated
партнер	Derivative
напарница	Derivative
пассажирк	Unmotivated
карандаш	Derivative
пастушка	Derivative
коронер	Derivative
покровительница	Derivative
педиатр	Unmotivated
кондитер	Derivative
сиделка	Derivative
пианистка	Derivative
пирожок	Derivative
пловчиха	Derivative
шлюха	Unmotivated
бизнес	Unmotivated
мошенница	Derivative
сокровищница	Derivative
коп	Derivative
полиция	Derivative
политика	Derivative
помощница	Derivative
советник	Derivative
пакстон	Unmotivated
слушательница	Derivative
проблема	Derivative
работник	Derivative
стажер	Unmotivated
права	Unmotivated
премьер-министр	Compound
президент	Derivative
принцесса	Derivative
продавщица	Derivative
продюсер	Derivative
профессор	Derivative
прокурорш	Derivative
проститутка	Derivative
первокурсница	Derivative
адвокат	Derivative
адвокат	Derivative
первопроходец	Compound
психиатр	Derivative
психопатка	Derivative
психиатp	Derivative
девушка	Derivative
публицист	Derivative
ханжа	Unmotivated
машинистка	Derivative
певица	Derivative
предшественница	Derivative
председатель	Derivative
переводчица	Derivative
истребительница	Derivative
луинелл	Unmotivated
редактор	Derivative
регент	Unmotivated
репортер	Derivative
ординатор	Derivative
поддержка	Derivative
самка	Derivative
хористка	Derivative
коллекционер	Derivative
сценаристка	Derivative
секретарь	Derivative
сенатор	Derivative
пионерка	Derivative
композитор	Derivative
слуга	Unmotivated
невеста	Derivative
судья	Derivative
соседка	Derivative
специалист	Derivative
оператор	Derivative
сокомандник	Derivative
пассажир	Derivative
помощник	Derivative
одноклассница	Derivative
спортсменка	Derivative
мэр	Unmotivated
стенографистка	Derivative
автостопщица	Derivative
стриптизерша	Derivative
хранитель	Derivative
хопс	Unmotivated
студентка	Derivative
создательница	Derivative
экзамен	Derivative
практикантка	Derivative
школьница	Derivative
киллерш	Unmotivated
супергероиня	Derivative
супермодель	Derivative
свадьба	Derivative
свидетельница	Derivative
воспитанница	Derivative
соблазнительница	Derivative
соблазнительница	Derivative
министр	Unmotivated
подросток	Derivative
теннисистка	Derivative
терапевть	Derivative
террористка	Derivative
автор	Unmotivated
переводчик	Derivative
толстушка	Derivative
бист	Unmotivated
карлица	Derivative
уретр	Unmotivated
труба	Unmotivated
скиталица	Derivative
туристка	Derivative
ручка	Derivative
кандидат	Derivative
уборщица	Derivative
художник	Derivative
беглянка	Derivative
ученица	Derivative
учитель	Derivative
лидер	Unmotivated
посол	Derivative
крестьянка	Derivative
ветеринар	Derivative
вице-президент	Compound
правительница	Derivative
кальянин	Derivative
код	Derivative
волейболистка	Derivative
убийца	Derivative
гувернантка	Derivative
редактор	Derivative
студентка	Derivative
следователь	Derivative
победительница	Derivative
наука	Unmotivated
провидец	Derivative
предсказательница	Derivative
лидер	Unmotivated
садовница	Derivative
пленница	Derivative
основательница	Derivative
сотрудница	Derivative
работодательница	Derivative
стенографистка	Derivative
арсенал	Derivative
медсестра	Derivative
золотоискательница	Derivative
воровка	Derivative
певица	Derivative
рыж	Derivative
предательница	Derivative
стоматолог	Derivative
разведчик	Derivative
парамедик	Derivative
клиентка	Derivative
кетчистка	Derivative
представитель	Derivative
похитительница	Derivative
блокировщица	Derivative
участник	Derivative
ведьма	Unmotivated
ведьма	Unmotivated
негритянка	Derivative
член	Unmotivated
читательница	Derivative
официантка	Derivative
дьяволица	Derivative
директор	Derivative
руль	Derivative
доска	Derivative
гардеробщица	Derivative
шеф	Unmotivated
школьница	Derivative
шпионаж	Derivative
сука	Unmotivated
начальница	Derivative
шеф-повар	Compound
босс	Unmotivated
редактор	Derivative
истица	Derivative
нищенка	Derivative
еврейка	Derivative
журналистика	Derivative
ученик	Derivative
