élève	Unmotivated
sharpston	Compound
agent	Derivative
activiste	Derivative
amateur	Unmarked
anarchiste	Derivative
archangelica	Derivative
anesthésiste	Derivative
anthropologue	Unmarked
archéologue	Unmarked
architecte	Derivative
aromathérapeute	Derivative
assistant	Unmarked
astronaute	Derivative
athlète	Unmotivated
auteure	Derivative
banquière	Derivative
serveuse	Derivative
baronne	Derivative
biologiste	Derivative
bête	Unmotivated
blogueur	Unmarked
blondinette	Derivative
guerrière	Derivative
flingue	Unmarked
patineur	Unmarked
batteur	Unmarked
poétesse	Derivative
joggeur	Unmarked
violoncelliste	Derivative
douanier	Derivative
usine	Derivative
chorégraphe	Compound
pupille	Derivative
certainesquestion	Compound
adultère	Derivative
pâtissière	Derivative
dresseur	Unmarked
empereur	Unmarked
croupière	Derivative
diagnostic	Unmotivated
carrelage	Derivative
cod	Unmotivated
entremetteur	Unmarked
docteur	Unmarked
ménage	Derivative
tutrice	Derivative
gardien	Derivative
musaraigne	Unmotivated
dure-à-cuire	Derivative
sosie	Derivative
donneur	Unmarked
démon	Unmotivated
héritière	Derivative
doyen	Unmotivated
ouvrière	Derivative
agent	Derivative
rédacteur	Unmarked
ex-femme	Derivative
fan	Derivative
fermier	Derivative
féministe	Derivative
canon	Unmotivated
junkie	Derivative
finaliste	Derivative
photographe	Compound
physiothérapeute	Derivative
géologue	Unmarked
golfeux	Derivative
matabeleland	Unmotivated
gymnaste	Derivative
gynécologue	Unmarked
acteur	Unmarked
présentateur	Unmarked
recherche	Derivative
baby-sitter	Compound
hautboïste	Derivative
colombe	Unmotivated
course-poursuite	Derivative
ménage	Derivative
hôtesse	Derivative
hôtesse	Derivative
violoniste	Derivative
comtesse	Derivative
héroïne	Derivative
équipe	Unmotivated
musicien	Derivative
pécheresse	Derivative
illustrateur	Unmarked
menominee	Unmotivated
informateur	Unmarked
inspecteur	Unmarked
professeur	Unmarked
stagiaire	Derivative
ingénieur	Unmarked
médium	Derivative
élève	Unmotivated
cavalier	Derivative
lézard	Unmotivated
oursin	Derivative
coiffeur	Unmarked
amie	Derivative
camérawoman	Derivative
raydor	Unmarked
canard	Unmotivated
clientèle	Derivative
patient	Unmotivated
filleul	Compound
bibliothécaire	Derivative
prêtresse	Derivative
collègue	Unmarked
commissaire	Derivative
congrès	Unmotivated
concurrante	Derivative
organisateur	Unmarked
sorcière	Derivative
cow-girl	Compound
liqueur	Unmarked
beauté	Derivative
patineur	Unmarked
finlay	Compound
criminel	Unmotivated
cristaux	Unmotivated
cuisinière	Derivative
probation	Derivative
quille	Derivative
fleur	Unmarked
moitié	Unmotivated
gauche	Unmotivated
menteur	Unmarked
chasseresse	Derivative
médecine	Derivative
guérisseur	Unmarked
propriétaire	Derivative
peintre	Unmotivated
manucure	Derivative
femme	Unmotivated
maquilleur	Unmarked
maso	Unmotivated
masseur	Unmarked
ours	Unmotivated
mentor	Unmarked
maîtresse	Derivative
madame	Unmotivated
secrétaire	Derivative
mannequins	Unmotivated
présentateur	Unmarked
salopette	Derivative
moto	Unmotivated
musicien	Derivative
martyre	Derivative
nazie	Derivative
ingénue	Derivative
droguée	Derivative
notaire	Derivative
journaliste	Derivative
épouse	Derivative
farce	Unmotivated
doublure	Derivative
locataire	Derivative
adjoint	Derivative
successeur	Unmarked
créateur	Unmarked
affaire	Derivative
admirateur	Unmarked
défense	Derivative
favorite	Derivative
résident	Unmotivated
médiatrice	Derivative
expert	Unmotivated
fusil	Unmotivated
gardien	Derivative
adulte	Unmotivated
opérateur	Unmarked
organisatrice	Derivative
jour	Unmotivated
ouverture	Derivative
esclave	Unmotivated
soin	Derivative
patient	Unmotivated
baguette	Derivative
vierge	Unmotivated
maytresse	Derivative
madame	Unmotivated
feuille	Derivative
partenariat	Derivative
partenaire	Derivative
passagère	Derivative
crayon	Unmotivated
bergère	Derivative
pathologiste	Derivative
protecteur	Unmarked
pédiatre	Derivative
pâtissière	Derivative
soin	Derivative
pianiste	Derivative
pirojki	Derivative
nageur	Unmarked
putain	Derivative
entrepreneur	Unmarked
fraude	Derivative
trésor	Unmarked
policier	Derivative
agent	Derivative
politique	Derivative
aide	Derivative
conseil	Unmotivated
paxton	Unmotivated
auditeur	Unmarked
fauteuse	Derivative
ministère	Derivative
stagiaire	Derivative
droit	Unmotivated
ministre	Unmotivated
présidente	Derivative
princesse	Derivative
vendeur	Unmarked
producteur	Unmarked
université	Derivative
procureur	Unmarked
sexe	Unmotivated
année	Derivative
avocat	Unmotivated
avocate	Derivative
pionnier	Derivative
psychologue	Unmarked
psychopathe	Derivative
psychothérapeut	Derivative
adolescent	Derivative
publiciste	Derivative
prude	Derivative
dactylo	Unmotivated
chanteur	Unmarked
prédécesseur	Unmarked
article	Unmotivated
traductrice	Derivative
tueur	Unmarked
luenell	Unmotivated
rédacteur	Unmarked
régent	Unmotivated
journaliste	Derivative
résident	Unmotivated
girl	Unmotivated
femelle	Derivative
danseur	Unmarked
collectionneur	Unmarked
auteur	Unmarked
secrétaire	Derivative
sénatrice	Derivative
scout	Unmotivated
compositeur	Unmarked
servante	Derivative
fiancée	Derivative
juge	Unmotivated
voisin	Derivative
spécialiste	Derivative
opératrice	Derivative
coéquipière	Derivative
passagère	Derivative
collaborateur	Unmarked
école	Unmotivated
athlet	Unmotivated
élection	Derivative
secrétaire	Derivative
auto-stoppeur	Derivative
strip-teaseux	Compound
garde	Unmotivated
hopps	Unmotivated
élève	Unmotivated
créateur	Unmarked
examen	Unmotivated
stagiaire	Derivative
lycéen	Derivative
tireur	Unmarked
super-héroïne	Derivative
model	Unmotivated
mariage	Derivative
témoin	Derivative
pupille	Derivative
séducteur	Unmarked
séducteur	Unmarked
secrétaire	Derivative
adolescent	Derivative
tennis	Derivative
thérapeute	Derivative
terroriste	Derivative
parolière	Derivative
traductrice	Derivative
fetichiste	Derivative
coach	Unmotivated
naine	Derivative
tube	Unmotivated
tuyau	Unmotivated
vagabonde	Derivative
randonneur	Unmarked
stylo	Unmotivated
stagiaire	Derivative
chambre	Unmotivated
artiste	Derivative
fugueur	Unmarked
apprentie	Derivative
instituteur	Unmarked
chef	Unmotivated
ambassadeur	Unmarked
paysan	Derivative
vétérinaire	Derivative
vice-présidente	Derivative
reine	Derivative
navet	Unmotivated
numéro	Unmotivated
volley	Unmotivated
meurtrier	Derivative
gouvemant	Unmarked
éditeur	Unmarked
université	Derivative
inspecteur	Unmarked
champion	Unmotivated
science	Unmotivated
gazette	Derivative
prophètesse	Derivative
chef	Unmotivated
jardinière	Derivative
prisonnier	Derivative
fondatrice	Derivative
travailleur	Unmarked
employeur	Unmarked
sténographe	Compound
armurerie	Derivative
bagnols	Unmotivated
croqueur	Unmarked
voleuse	Derivative
chanteur	Unmarked
rouquine	Derivative
traîtresse	Derivative
hygiéniste	Derivative
espion	Unmotivated
ãªtres	Derivative
client	Unmotivated
catcheuse	Derivative
vice-président	Derivative
ravisseur	Unmarked
marqueur	Unmarked
partie	Derivative
sorcière	Derivative
sorcière	Derivative
négresse	Derivative
commission	Compound
lectrice	Derivative
serveux	Derivative
diablesse	Derivative
cadre	Unmotivated
conducteur	Unmarked
plateau	Derivative
vestiaire	Derivative
sheriff	Unmotivated
fille	Derivative
espionnage	Derivative
pinceau	Unmotivated
patronne	Derivative
chef	Unmotivated
patronne	Derivative
éditeur	Unmarked
tribunal	Derivative
tamile	Unmotivated
gréco-hindou-japonais-juif	Derivative
safari	Unmotivated
élève	Unmotivated
