Absolventin	Derivative
Generalanwältin	Derivative
Agent	Unmarked
Aktivistin	Derivative
Amateurin	Derivative
Anarchistin	Derivative
Engelwurz	Compound
Anästhesistin	Derivative
Ethikerin	Derivative
Archäologin	Derivative
Architektin	Derivative
Aromatherapeutin	Derivative
Assistentin	Derivative
Astronautin	Derivative
Laufstar	Compound
Autorin	Derivative
Bankerin	Derivative
Barkeeperin	Derivative
Baronin	Derivative
Walbiologin	Derivative
Idiotin	Derivative
Bloggerin	Derivative
Blondine	Derivative
Kämpferin	Derivative
Waffe	Unmotivated
Eiskunstläuferin	Derivative
Drummerin	Derivative
Dichterin	Derivative
Joggerin	Derivative
Cellistin	Derivative
Zoll	Unmotivated
Chemiewerk	Compound
Choreografin	Derivative
Mündel	Unmotivated
Ausländerin	Derivative
Ehebrecherin	Derivative
Konditorin	Derivative
Trainerin	Derivative
Kaiserin	Derivative
Drogendealerin	Derivative
Diagnose	Derivative
Fliesen	Unmotivated
Privatdozentin	Derivative
Kupplerin	Derivative
Doktor	Unmarked
Haushälterin	Derivative
Privatlehrerin	Derivative
Aufseherin	Derivative
Drachen	Unmotivated
Draufgängerin	Derivative
Doppelgängerin	Derivative
Spender	Unmarked
Minchin-Drache	Compound
Kaufhaus-Erbin	Compound
Dekan	Unmotivated
Arbeiterin	Derivative
Offizier	Unmarked
Redakteurin	Derivative
Ex-Frau	Derivative
Fan	Unmotivated
Bäuerin	Derivative
Feministin	Derivative
Mädchen	Unmotivated
Junkie	Derivative
Finalistin	Derivative
Fotografin	Derivative
Physiotherapeutin	Derivative
Geologin	Derivative
Golferin	Derivative
Gouverneurin	Derivative
Gymnastin	Derivative
Frauenärztin	Derivative
Schauspielerin	Derivative
Sprecherin	Derivative
Fahndung	Derivative
Wachfrau	Compound
Oboistin	Derivative
Taube	Unmotivated
Jagd	Unmotivated
Haushälterin	Derivative
Tischdame	Compound
Gastgeberin	Derivative
Geigerin	Derivative
Gräfin	Derivative
Frau	Unmotivated
Spielerin	Derivative
Musikerin	Derivative
Sünderin	Derivative
Illustratorin	Derivative
Indianerin	Derivative
Informantin	Derivative
Inspektor	Unmarked
Ausbilderin	Derivative
Praktikantin	Derivative
Ingenieurin	Derivative
Hellseherin	Derivative
Einser-Schülerin	Compound
Reiterin	Derivative
Eidechse	Compound
Seeigel	Compound
Friseurin	Derivative
Freundin	Derivative
Kamerafrau	Compound
Kapitän	Unmotivated
Ente	Unmotivated
Klientel	Derivative
Kundin	Derivative
Gevatterin	Derivative
Bibliothekarin	Derivative
Priesterin	Derivative
Kollegin	Derivative
Kommissarin	Derivative
Politiker-Familie	Compound
Konkurrentin	Derivative
Koordinatorin	Derivative
Zauberin	Derivative
Reiterstellung	Compound
Alkohol	Unmotivated
Mädchen	Unmotivated
Schlittschuhläuferin	Derivative
Kriminaltechnikerin	Derivative
Verbrecher	Unmarked
Kristallpulver	Unmarked
Köchin	Derivative
Bewährungshelferin	Derivative
Zusatzscheiben	Compound
Blumenmädchen	Compound
Mädchen	Unmotivated
Linkshänderin	Derivative
Lügnerin	Derivative
Kopfgeldjägerin	Derivative
Ärztin	Derivative
Heilerin	Derivative
Besitzerin	Derivative
Malerin	Derivative
Handpflegerin	Derivative
Ehegatte	Compound
Maskenbildnerin	Derivative
Masochistin	Derivative
Masseurin	Derivative
Bärentraube	Compound
Mentorin	Derivative
Mätresse	Derivative
Ladyschaft	Derivative
Ministerin	Derivative
Modell	Unmotivated
Moderatorin	Derivative
Arbeitsanzug	Compound
Motorrad	Compound
Musikerin	Derivative
Märtyrerin	Derivative
NaZi-Frau	Compound
Katalog-Käufer	Compound
Junkie	Derivative
Notarin	Derivative
Journalistin	Derivative
Frau	Unmotivated
Füllung	Derivative
Stellvertreterin	Derivative
Mieterin	Derivative
Ministerin	Derivative
Nachfolgerin	Derivative
Designerin	Derivative
Geschäftsfrau	Compound
Bewunderin	Derivative
Anwalt	Unmotivated
Liebling	Derivative
Einwohnerin	Derivative
Beschützerin	Derivative
Expertin	Derivative
Scharfschützengewehr	Compound
Kindermädchen	Compound
Vormund	Compound
Telefonistin	Derivative
Organisatorin	Derivative
Geburtstagskind	Compound
Eröffnung	Unmotivated
Sklavin	Derivative
Krankenschwester	Unmarked
Patientin	Derivative
Schlagel	Unmotivated
Jungfrau	Compound
Herrscherin	Derivative
Wunsch	Unmotivated
Blättchen	Derivative
Partnerin	Derivative
Partnerin	Derivative
Passagierin	Derivative
Farbstift	Compound
Hirtin	Derivative
Gerichtsmedizinerin	Derivative
Gönnerin	Derivative
Kinderärztin	Derivative
Bäckerin	Derivative
Pflegekraft	Compound
Konzertpianistin	Derivative
Käse-Piroge	Compound
Schwimmerin	Derivative
Flittchen	Derivative
Unternehmerin	Derivative
Betrügerin	Derivative
Schatzkammer	Unmarked
Polizistin	Derivative
Polizistin	Derivative
Politikerin	Derivative
Gehilfin	Derivative
Beraterin	Derivative
Lieutenant	Unmarked
Zuhörerin	Derivative
Problem	Unmotivated
Sozialarbeiterin	Derivative
Praktikantin	Derivative
Recht	Unmotivated
Premierministerin	Derivative
Präsidentin	Derivative
Prinzessin	Derivative
Verkäuferin	Derivative
Produzentin	Derivative
Professorin	Derivative
Bezirksstaatsanwältin	Derivative
Prostituierte	Unmotivated
Studienanfängerin	Derivative
Anwalt	Unmotivated
Anwältin	Derivative
Vorreiterin	Derivative
Psychologin	Derivative
Psychophantin	Derivative
Psychotherapeutin	Derivative
Mädchen	Unmotivated
PR-Beraterin	Compound
Puritanerin	Derivative
Schreibkraft	Compound
Opernsängerin	Derivative
Vorgängerin	Derivative
Präsidentin	Derivative
Übersetzerin	Derivative
Jägerin	Derivative
Freundin	Derivative
Redakteurin	Derivative
Regentin	Derivative
Reporterin	Derivative
Assistenzärztin	Derivative
Cheerleaderin	Derivative
Weibchen	Derivative
Revuetänzerin	Derivative
Sammlerin	Derivative
Drehbuchautorin	Derivative
Sekretärin	Derivative
Senatorin	Derivative
Pfadfinderin	Derivative
Komponistin	Derivative
Dienerin	Derivative
Verloben	Unmotivated
Richterin	Derivative
Nachbarin	Derivative
Spezialistin	Derivative
Telefonistin	Derivative
Teamkollegin	Derivative
Beifahrerin	Derivative
Kollegin	Derivative
Mitschülerin	Derivative
Sportlerin	Derivative
Bürgermeisterin	Derivative
Stenotypistin	Derivative
Anhalterin	Derivative
Stripperin	Derivative
Hüterin	Derivative
Wachstube	Compound
Schülerin	Derivative
Erzeugerin	Derivative
Prüfung	Derivative
Praktikantin	Derivative
Highschool-Mädchen	Compound
Schützin	Derivative
Superheldin	Derivative
Supermodel	Derivative
Hochzeit	Unmarked
Zeugin	Derivative
Mündel	Unmotivated
Verführerin	Derivative
Verführerin	Derivative
Sekretärin	Derivative
Teenager	Unmarked
Spielerin	Derivative
Therapeutin	Derivative
Terroristin	Derivative
Texterin	Derivative
Dolmetscherin	Derivative
Übergrös	Compound
Trainerin	Derivative
Zwerg	Unmotivated
Verfahren	Unmotivated
Wasser	Unmarked
Landstreicherin	Derivative
Touristin	Derivative
Bleistift	Compound
Kandidatin	Derivative
Putzfrau	Compound
Künstlerin	Derivative
Asylantin	Derivative
Schülerin	Derivative
Lehrerin	Derivative
Commander	Unmarked
Botschafterin	Derivative
Mädchen	Unmotivated
Tierarzt	Compound
Präsidentin	Derivative
Kaiserin	Derivative
Speiserub	Compound
Vorwahl	Compound
Profi-Frauen-Volleyballteam	Compound
Mörderin	Derivative
Erzieherin	Derivative
Geberin	Derivative
Collegestudentin	Derivative
Privatdetektivin	Derivative
Gewinnerin	Derivative
Wissenschaftlerin	Derivative
Tagesprophet	Compound
Wahrsagerin	Derivative
Anführerin	Derivative
Gärtnerin	Derivative
Russinen	Derivative
Gründerin	Derivative
Arbeitnehmerin	Derivative
Arbeitgeberin	Derivative
Gerichtsreporterin	Derivative
Arsenal	Derivative
Krankenschwester	Unmarked
Goldgräberin	Derivative
Zugräuberin	Derivative
Sängerin	Derivative
Rotschopf	Compound
Verräterin	Derivative
Zahnärztin	Derivative
Spion	Unmotivated
Sanitäterin	Derivative
Kundin	Derivative
Wrestlerin	Derivative
Sonderbeauftragt	Compound
Entführerin	Derivative
Bombenlegerin	Derivative
Streithelferin	Derivative
Hexe	Derivative
Hexe	Derivative
Negerin	Derivative
Kommission	Unmotivated
Langsamleser	Unmarked
Kellnerin	Derivative
Satansbrat	Compound
Direktorin	Derivative
Fahrerin	Derivative
Schachbrett	Compound
Garderobier	Unmarked
Sheriff	Unmotivated
Schulmädchen	Compound
Spionage	Derivative
Apparat	Unmotivated
Chefin	Derivative
Chefköchin	Derivative
Chefin	Derivative
Redakteurin	Derivative
Klägerin	Derivative
Bettlerin	Derivative
Hebräerin	Derivative
Tierverhalten	Compound
Schülerin	Derivative
